id,name,registeredMen,registeredWomen,registeredNomad,registeredHinduSikh,registeredTotal
102,PAGHMAN,37615,19389,852,11,57867
103,CHAHAR ASYAB,21161,12517,1273,7,34958
104,BAGRAMI,51470,24471,7989,19,83949
105,DEHSABZ,27848,13563,1198,169,42778
106,SHAKAR DARA,25193,14024,1939,11,41167
107,MUSAHI,13750,10033,1286,5,25074
108,MIR BACHA KOT,14729,7640,99,11,22479
109,KHAK-E-JABAR,8342,8228,685,2,17257
110,KALAKAN,9073,4818,43,1,13935
111,GULDARA,4471,3877,98,0,8446
112,FARZA,6255,4126,18,3,10402
113,ESTALEF,7571,4515,89,1,12176
114,QARA BAGH,31898,13877,1007,11,46793
115,SURUBI,33220,20887,1684,17,55808
201,PROVINCIAL CAPITAL OF KAPISA (MAHMUDI RAQI),13902,5796,10101,0,29799
202,HISSA-E- DUWUMI KOHISTAN,14624,7482,747,0,22853
203,KOH BAND,12340,8003,355,0,20698
204,HISSA-E-AWALI KOHISTAN,18762,9198,540,0,28500
205,NIJRAB,20145,11839,556,0,32540
206,TAGAB,16634,1843,549,0,19026
207,ALASAY,3165,0,59,0,3224
301,PROVINCIAL CAPITAL OF PARWAN (CHARIKAR),37854,15814,120,0,53788
302,BAGRAM,34161,15494,885,0,50540
303,SHINWARI,11268,3504,12,0,14784
304,SAYID KHAIL,11147,7411,39,0,18597
305,JABULUSSARAJ,13678,7931,9,0,21618
306,SALANG,6846,6706,110,0,13662
307,SYAHGIRDI GHORBAND,8949,3774,2,0,12725
308,KOHI SAFI,3242,2601,1,0,5844
309,SURKHI PARSA,6839,5915,6,0,12760
310,SHAYKH ALI,5728,3808,2,0,9538
401,PROVINCIAL CAPITAL OF WARDAK (MAYDAN SHAHR),19078,2180,518,0,21776
402,NERKH,9928,1948,6,0,11882
403,JALREZ,9721,5548,3,0,15272
404,CHAKI WARDAK,17652,4402,12,0,22066
405,SAYYDABAD,16139,3226,48,0,19413
406,DAYMIRDAD,1604,844,3,0,2451
407,HISSA-E-AWALI BIHSUD,6999,6403,5,0,13407
408,JAGHATU,1748,1181,0,0,2929
409,MARKAZ-E-BEHSUD,17522,15358,19,0,32899
501,PROVINCIAL CAPITAL OF  LOGAR ( PULI ALAM ),30201,6799,5605,0,42605
502,BARAKI BARAK,2342,332,4,0,2678
503,CHARKH,1214,0,969,0,2183
504,KHUSHI,6951,4047,1899,0,12897
505,MOHAMMAD AGHA,24351,9634,1231,0,35216
506,KHAR WAR,39,0,2,0,41
507,AZRA,2645,2850,42,0,5537
602,BEHSUD,46541,24956,1658,46,73201
603,SURKH RUD,48423,24508,1760,10,74701
604,CHAPARHAR,18690,13279,223,12,32204
605,KAMA,29197,19203,345,6,48751
606,KUZKUNAR,21653,11455,1029,13,34150
607,RODAT,26095,13190,536,6,39827
608,KHUGYANI,37989,13346,1091,2,52428
609,BATI KOT,21500,10314,1206,13,33033
610,DEH BALA,6141,2905,6,2,9054
611,PACHIR WAGAM,12387,5179,236,2,17804
612,DARAH-E-NOOR,17300,17004,17,6,34327
613,KOT,15847,10789,57,2,26695
614,GOSHTA,11230,9335,15,2,20582
615,ACHIN,16301,5527,32,3,21863
616,SHINWAR,17910,6802,437,4,25153
617,MUHMAND DARA,19577,9137,363,4,29081
618,LALPOOR,8795,4267,10,2,13074
619,SHER ZAD,1151,566,0,0,1717
620,NAZYAN,9013,6841,5,9,15868
621,HESARAK,3243,2264,119,3,5629
622,DUR BABA,13792,6500,48,3,20343
623,SPIN GHAR,11097,5060,34,3,16194
701,PROVINCIAL CAPITAL OF LAGHMAN ( MEHTERLAM ),48225,17728,321,0,66274
702,QARGHAYEE,35362,20279,3685,0,59326
703,ALISHING,7988,2890,530,0,11408
704,ALINGAR,9598,2544,48,0,12190
705,DAWLAT SHAH,8458,3266,136,0,11860
706,BAD PAKH,492,7,0,0,499
801,PROVINCIAL CAPITAL OF PANJSHER ( BAZARAK ),8664,4029,4,0,12697
802,RUKHA,3194,2397,0,0,5591
803,DARAH,4710,3574,4,0,8288
804,HISSA-E-AWAL ( KHINJ ),8732,6276,9,0,15017
805,UNABA,6971,4682,4,0,11657
806,SHUTUL,2453,2621,1,0,5075
807,PARYAN,4181,3693,1,0,7875
808,AB SHAR,3859,3373,6,0,7238
901,PROVINCIAL CAPITAL OF BAGHLAN ( PUL-E-KHUMRI ),34040,21417,334,0,55791
903,DUSHI,15088,13796,319,0,29203
904,NAHREEN,30057,23062,930,0,54049
905,BAGHLAN-E-JADEED,47650,28696,3816,0,80162
906,KHINJAN,6254,6304,56,0,12614
907,ANDARAB,6134,4870,8,0,11012
908,DEH SALAH,13336,6140,20,0,19496
909,JALGA,12411,8615,7,0,21033
910,BURKA,10675,9307,13,0,19995
911,TALA WA BARFAK,17869,15423,10,0,33302
912,PUL-E-HISAR,11353,8070,10,0,19433
913,KHOST WA FIRING,23284,15320,91,0,38695
914,GOZARGAH-E-NOOR,3551,3549,1,0,7101
915,FIRING WA GHARU,5467,4982,6,0,10455
1001,PROVINCIAL CAPITAL OF BAMYAN ( BAMYAN ),21743,21396,5,0,43144
1002,SHEBAR,5154,3874,2,0,9030
1003,SAIGHAN,5170,6254,3,0,11427
1004,KAHMARD,10376,10200,31,0,20607
1005,YAKAWLANG,11981,12667,2,0,24650
1006,PANJAB,8334,8812,12,0,17158
1007,WARAS,13605,15126,7,0,28738
1008,YAKAWLANG NO 2,5745,6819,2,0,12566
1201,PROVINCIAL CAPITAL OF PAKTIKA ( SHARAN ),16700,976,1611,0,19287
1202,MATA KHAN,9083,4459,325,0,13867
1203,YOSUF KHEL,7323,1940,284,0,9547
1204,YAHYA KHEL,11697,2673,250,0,14620
1205,SAR RAWZA,4017,1194,413,0,5624
1206,OMNA,832,388,55,0,1275
1207,ZARGHUN SHAHR,20644,3722,648,0,25014
1208,GOMAL,9963,4101,87,0,14151
1209,JANI KHEL,9466,2476,2472,0,14414
1210,SURUBI,11023,4417,56,0,15496
1211,URGOON,13267,5646,112,0,19025
1212,ZIRUK,7539,1936,8,0,9483
1213,NIKA,5223,1423,4,0,6650
1214,BARMAL,8800,412,4,0,9216
1216,DILA WA KHUSHAMAND,4132,665,662,0,5459
1217,WAZAKHWAH,9224,217,401,0,9842
1218,WOR MAMAY,4676,1358,846,0,6880
1219,TURWO,4797,608,1796,0,7201
1301,PROVINCIAL CAPITAL OF PAKTYA ( GARDEZ ),32870,15260,1877,0,50007
1302,AHMADABA,11583,14011,735,0,26329
1303,ZURMAT,28408,4031,881,0,33320
1304,SHWAK,4806,3755,8,0,8569
1305,WUZA JADRAN,11871,7058,4,0,18933
1306,SAYYID KARAM,11789,9696,46,0,21531
1307,JAJI,29814,27163,50,0,57027
1308,LAJA AHMAD KHEL,13189,11934,7,0,25130
1309,JANI KHEL,11962,9350,5,0,21317
1310,SAMKANI,19965,15262,33,0,35260
1311,DAND PATAN,12789,14574,11,0,27374
1312,LAJA MANGAL,9126,10119,8,0,19253
1313,MIRZAKA,7485,9582,35,0,17102
1314,GARDA SIRAY,5201,3846,0,0,9047
1315,ROHANI BABA,11237,1844,385,0,13466
1401,PROVINCIAL CAPITAL OF KHOST ( KHOST ),53635,10486,4020,0,68141
1402,MANDUZAY (ESMAYEL KHEL),14351,4166,30,0,18547
1403,GURBUZ,8469,3818,836,0,13123
1404,TANAY,14694,7247,15,0,21956
1405,MUSA KHEL,8265,6054,17,0,14336
1406,NADIRSHAH KOT,7394,1344,3,0,8741
1407,SABARI (YAQUBI),17634,4631,76,0,22341
1408,ALI SHER,12547,3259,1015,0,16821
1409,BAAK,6763,3053,7,0,9823
1410,QALANDAR,4927,2113,2,0,7042
1411,SPERA,8950,1327,29,0,10306
1412,SHAMUL,5425,1203,6,0,6634
1413,JAJI MAIDAN,9327,6837,25,0,16189
1501,PROVINCIAL CAPITAL OF KUNARHA ( ASAD ABAD ),14170,6881,7,0,21058
1502,MARA WARA,6358,4671,3,0,11032
1503,WATAPOOR,3459,1040,0,0,4499
1504,NARANG WA BADIL,6826,3557,6,0,10389
1505,SAR KANI,9180,5772,230,0,15182
1506,SHIGAL WA SHELTAN,9299,5106,4,0,14409
1507,DARA-E-PECH,9147,5235,1,0,14383
1508,BAR KUNAR,5941,2780,2,0,8723
1509,SAWKAI,9962,5978,1,0,15941
1510,KHAS KUNAR,9259,7236,10,0,16505
1511,GHAZI ABAD,2326,779,2,0,3107
1512,DANGAM,4858,1091,1,0,5950
1513,CHAPA DARA,2865,520,1,0,3386
1514,NOOR GAL,5686,3355,18,0,9059
1515,NARI,6763,6526,1,0,13290
1516,SHELTAN,2275,451,2,0,2728
1601,PROVINCIAL CAPITAL OF NOORISTAN ( PAROON ),6389,4446,3,0,10838
1602,WAYGAL,5917,3621,0,0,9538
1603,WAMA,7408,5159,11,0,12578
1604,NOOR GRAM,7259,2970,8,0,10237
1605,DUAB,5013,1588,11,0,6612
1606,KAMDESH,4223,2575,5,0,6803
1608,BARG-E-MATAL,5915,4545,2,0,10462
1701,PROVINCIAL CAPITAL OF BADAKHSHAN ( FAIZ ABAD ),16730,11754,15,0,28499
1702,ARGO,17424,12242,13,0,29679
1703,ARGHANJ KHWAH,2514,1163,5,0,3682
1704,YAFTAL-E-SUFLA,11515,10096,17,0,21628
1705,KHASH,5716,3609,9,0,9334
1706,BAHARAK,8795,5402,32,0,14229
1707,DARAYIM,8570,7594,5,0,16169
1708,KOHISTAN,2348,678,2,0,3028
1709,YAWAN,8650,4649,8,0,13307
1710,JURM,8455,5140,3,0,13598
1711,TASHKAN,6884,5095,3,0,11982
1712,SHUHADA,5034,4253,8,0,9295
1713,SHAHR-E-BUZURG,7832,5477,3,0,13312
1714,RAGHISTAN,6209,884,4,0,7097
1715,KISHM,20104,15043,90,0,35237
1717,TAGAB,4071,2543,12,0,6626
1719,SHIGHNAN,3503,3848,4,0,7355
1720,KHWAHAN,3787,2938,2,0,6727
1721,KUFAB,4648,3552,7,0,8207
1722,DARWAZ-E-PAYIN (MAMAY),3769,4237,7,0,8013
1723,ESHKASHIM,2808,2467,21,0,5296
1724,SHIKI,2672,3193,2,0,5867
1725,ZEBAK,1487,1464,0,0,2951
1726,KIRAN WA MENJAN,2316,1179,4,0,3499
1727,DARWAZ-E-BALA (NESAY),3295,3411,8,0,6714
1728,WAKHAN,2433,2028,3,0,4464
1801,PROVINCIAL CAPITAL OF TAKHAR ( TALUQAN ),39058,28628,53,0,67739
1802,HAZAR SUMUCH,3712,3363,3,0,7078
1803,BAHARAK,7086,6680,9,0,13775
1804,BANGI,8621,7787,18,0,16426
1805,CHAL,5914,5819,0,0,11733
1806,NAMAK AB,2557,1647,1,0,4205
1807,KALAFGAN,8146,10744,7,0,18897
1808,FARKHAR,10073,11112,1,0,21186
1809,KHWAJA GHAR,3749,4006,238,0,7993
1810,RUSTAQ,24635,20408,6,0,45049
1811,ESHKAMESH,11027,10269,9,0,21305
1813,WARSAJ,6817,8726,9,0,15552
1814,KHWAJA BAHAWUDDIN,4258,3298,3,0,7559
1815,DARQAD,743,369,12,0,1124
1816,CHAHAB,12956,10504,4,0,23464
1817,YANGI QALA,3197,2059,1,0,5257
1901,PROVINCIAL CAPITAL OF KUNDUZ ( KUNDUZ ),52506,25168,87,0,77761
1902,CHAR DARAH,2641,957,0,0,3598
1903,ALI ABAD,4348,3460,7,0,7815
1904,KHAN ABAD,12953,9872,15,0,22840
1905,HAZRATI IMAM SAHIB,25971,15163,13,0,41147
1906,DASHTI-E-ARCHI,5951,3323,3,0,9277
1907,QALA-E-ZAL,1242,1340,1,0,2583
1910,AQTASH,3220,1560,1,0,4781
2001,PROVINCIAL CAPITAL OF SAMANGAN ( AYBAK ),17256,15527,45,0,32828
2002,HAZRAT-E-SULTAN,8736,8525,19,0,17280
2003,KHURAM WA SARBAGH,4816,4556,1,0,9373
2004,FEROZ NAKHCHEER,2651,3375,1,0,6027
2005,ROI-DO-AB,9725,9955,5,0,19685
2006,DARA-E-SOOF-E-PAYIN,12529,6338,3,0,18870
2007,DARA-E-SOOF-E-BALA,14887,15256,1,0,30144
2102,NAHR-E-SHAHI,14344,12782,77,0,27203
2103,DEHDADI,15062,11990,20,0,27072
2104,CHAR KENT,12529,7331,9,0,19869
2105,MARMUL,5282,3872,5,0,9159
2106,BALKH,20885,17810,2533,0,41228
2107,SHOLGARA,23536,23606,727,0,47869
2108,CHIMTAL,10774,8317,206,0,19297
2109,DAWLAT ABAD,9417,8474,40,0,17931
2110,KHULM,10565,9144,6,0,19715
2111,CHAR BOLAK,10194,6743,1009,0,17946
2112,SHORTEPA,7129,2234,1,0,9364
2113,KALDAR,5227,3104,5,0,8336
2114,KISHINDEH,11731,8839,10,0,20580
2115,ZARI,17197,10609,9,0,27815
2201,PROVINCIAL CAPITAL OF SAR-E-PUL ( SAR-E-PUL ),26043,22669,44,0,48756
2202,SAYAD,3641,2746,1,0,6388
2204,SOZMA QALA,2854,3257,3,0,6114
2205,SANGCHARAK,12754,15264,22,0,28040
2206,GOSFANDI,8497,7813,766,0,17076
2207,BALKHAB,14585,14624,17,0,29226
2301,PROVINCIAL CAPITAL OF GHOR ( CHIGHCHERAN ),44813,26036,233,0,71082
2302,DULEENA,9592,5693,9,0,15294
2303,DAWLATYAR,14144,11191,24,0,25359
2304,CHAR SADA,4371,1928,0,0,6299
2305,PASABAND,3071,1770,2,0,4843
2306,SHAHRAK,19675,8053,25,0,27753
2307,LAL WA SARJANGAL,21682,19541,12,0,41235
2308,TAYWARA,15654,3913,34,0,19601
2309,TULAK,14529,6133,23,0,20685
2310,SAGHAR,5508,1305,11,0,6824
2401,PROVINCIAL CAPITAL OF DAYKUNDI ( NILI ),8325,9538,4,0,17867
2402,SHAHRISTAN,12868,14001,11,0,26880
2403,GIZAB,4942,5918,2,0,10862
2404,ISHTERLAI,8102,8976,10,0,17088
2405,KHEDIR,7870,8792,6,0,16668
2406,GETI,7809,12725,6,0,20540
2407,MIRAMOR,12258,16066,10,0,28334
2408,SANG-E-TAKHT,7914,8426,6,0,16346
2409,KEJRAN,5379,6966,12,0,12357
2501,PROVINCIAL CAPITAL OF UROZGAN ( TIRINKOT ),28229,1564,70,0,29863
2502,DEHRAOUD,13047,58,190,0,13295
2503,CHORA,5562,51,2,0,5615
2506,CHINARTO,1333,0,58,0,1391
2507,GIZAB,5861,294,6,0,6161
2601,PROVINCIAL CAPITAL OF ZABUL ( QALAT ),25473,2630,2819,0,30922
2602,TARANK WA JALDAK,5114,213,63,0,5390
2603,SHINKAI,3792,57,56,0,3905
2604,MIZAN,1902,7,164,0,2073
2605,ARGHANDAB,23097,1013,460,0,24570
2605,ARGHANDAB,374,0,1,0,375
2606,SHAH JOI,14226,29,715,0,14970
2608,ATGHAR,1436,0,0,0,1436
2609,NAW BAHAR,576,0,0,0,576
2610,SHEMEL ZAYI,4638,427,11,0,5076
2703,DAMAN,15613,2024,1355,0,18992
2704,PANJWAYEE,24624,769,335,0,25728
2705,ZHIRE,29193,380,918,0,30491
2706,SHAH WALI KOT,3475,63,364,0,3902
2707,KHAKREZ,377,32,0,0,409
2708,ARGHISTAN,9094,106,31,0,9231
2709,GHORAK,563,0,1,0,564
2710,MAIWAND,7865,159,75,0,8099
2711,SPIN BOLDAK,72266,11801,2015,0,86082
2714,SHORABAK,199,0,4,0,203
2716,REG (SHIGA),148,0,13,0,161
2717,DAND,21875,2131,1227,0,25233
2718,TAKHTA PUL,9336,1767,271,0,11374
2801,PROVINCIAL CAPITAL OF JAWZJAN ( SHEBERGHAN ),26943,30715,247,0,57905
2802,KHWAJA DUKOH,5186,6943,40,0,12169
2803,KHANAQA,1087,1487,2,0,2576
2804,MINGAJIK,660,154,0,0,814
2805,QUSH TEPA,1258,1228,8,0,2494
2806,KHAMYAB,91,25,0,0,116
2807,AQCHAH,6881,5043,6,0,11930
2808,FAIZABAD,2758,2076,1,0,4835
2810,QARQIN,1606,708,1,0,2315
2901,PROVINCIAL CAPITAL OF FARYAB ( MAIMANA ),19678,17497,33,0,37208
2902,PASHTUN KOT,9193,7307,4,0,16504
2903,KHWAJA SABZ POSH,944,730,1,0,1675
2904,ALMAR,6124,4382,8,0,10514
2905,BILCHIRAGH,7952,6450,5,0,14407
2906,SHIRIN TAGAB,1463,2159,0,0,3622
2907,QAISAR,23000,16204,50,0,39254
2908,GURZIWAN,7931,2975,1,0,10907
2909,DAWLAT ABAD,3196,2096,4,0,5296
2911,QARAM QUL,3175,4164,3,0,7342
2912,QURGHAN,6113,5214,2,0,11329
2913,ANDKHOY,11526,10994,25,0,22545
2914,KHANI CHARBAGH,4159,4802,2,0,8963
3001,PROVINCIAL CAPITAL OF HELMAND (LASHKARGAH),136561,24113,2012,4,162690
3002,NAD ALI,35194,4403,160,0,39757
3003,NAWA-E-BARIKZAYI,32598,2831,360,0,35789
3004,NAHR-E-SARAJ,31446,5430,282,0,37158
3005,WASHER,3822,3,73,0,3898
3006,GARM SER,8059,188,45,0,8292
3008,SANGIN QALA,926,0,0,0,926
3010,KAJAKI,367,0,0,0,367
3014,MARJA,8963,439,53,0,9455
3015,NAWAMISH,3773,4272,1,0,8046
3101,PROVINCIAL CAPITAL OF BADGHIS ( QALA-E-NOW ),17805,14113,38,0,31956
3102,AB KAMARI,8616,6302,23,0,14941
3103,MUQUR,2915,1448,349,0,4712
3104,QADIS,2905,1808,3,0,4716
3105,BALA MURGHAB,13193,2692,720,0,16605
3106,JAWAND,11417,5725,10,0,17152
3107,GHORMACH,3094,795,336,0,4225
3202,ENJIL,36915,33813,434,0,71162
3203,NIZAM-E-SHAHID (GUZARA),31395,22911,422,0,54728
3204,KARRUKH,14407,13004,83,0,27494
3205,ZENDAJAN,7348,7810,1,0,15159
3206,PASHTUN ZARGHUN,11691,6256,26,0,17973
3207,KUSHK (RUBAT-E-SANGI),19400,13947,297,0,33644
3208,GULRAN,3031,2436,2,0,5469
3209,ADRASKAN,4298,2343,3,0,6644
3210,KUSHK-E-KUHNA,9565,5743,216,0,15524
3211,GHORYAN,17173,16841,29,0,34043
3212,OBE,8442,2812,10,0,11264
3213,KOHSAN,13874,11780,22,0,25676
3214,SHINDAND,5864,2570,7,0,8441
3215,FERSI,1714,1086,0,0,2800
3216,CHISHT-E-SHARIF,832,565,3,0,1400
3219,KOH-I-ZOR,1050,61,2,0,1113
3220,ZAWOL,1770,855,2,0,2627
3301,PROVINCIAL CAPITAL OF FARAH (FARAH),33172,18352,486,0,52010
3302,PUSHTRUD,296,0,0,0,296
3304,QALA-E-KAH,848,285,9,0,1142
3305,SHIBKOH,234,110,0,0,344
3306,BALA BULUK,2894,0,1,0,2895
3307,ANAR DARA,1017,857,30,0,1904
3308,BAKWA,559,0,13,0,572
3309,LASH-E-JUWAYN,2845,2864,0,0,5709
3310,GULISTAN,553,111,13,0,677
3311,PUR CHAMAN,274,2,0,0,276
3401,PROVINCIAL CAPITAL OF NIMROZ (ZARANJ),30106,16143,340,0,46589
3402,KANG,6843,4040,29,0,10912
3403,ASL-E-CHAKHANSUR,5486,3591,66,0,9143
3404,CHAR BURJAK,5979,2101,326,0,8406
3405,KHASHROD,6001,732,134,0,6867
3406,DULARAM,10653,2,31,0,10686
10101,Nahia 01,15354,4966,44,126,20490
10102,Nahia 02,24703,7770,75,21,32569
10103,Nahia 03,28131,11833,39,10,40013
10104,Nahia 04,34205,16629,341,149,51324
10105,Nahia 05,54995,21475,1615,11,78096
10106,Nahia 06,42657,29318,165,15,72155
10107,Nahia 07,47427,25941,165,11,73544
10108,Nahia 08,62000,27841,1761,17,91619
10109,Nahia 09,38626,15774,218,7,54625
10110,Nahia 10,40975,23747,130,11,64863
10111,Nahia 11,54088,26463,76,17,80644
10112,Nahia 12,68644,23683,2229,24,94580
10113,Nahia 13,71927,57774,97,11,129809
10114,Nahia 14,6048,1885,19,0,7952
10115,Nahia 15,47774,22815,1288,21,71898
10116,Nahia 16,29194,13086,630,2,42912
10117,Nahia 17,38219,16623,309,7,55158
10118,Nahia 18,10320,2229,422,4,12975
10119,Nahia 19,9075,3159,177,1,12412
10121,Nahia 21,20402,4453,39627,21,64503
10122,Nahia 22,3825,2785,352,5,6967
60101,PROVINCIAL CAPITAL OF NANGARHAR ( JALALABAD ),16083,5556,586,51,22276
60102,PROVINCIAL CAPITAL OF NANGARHAR ( JALALABAD ),22581,5776,448,8,28813
60103,PROVINCIAL CAPITAL OF NANGARHAR ( JALALABAD ),20598,10097,346,5,31046
60104,PROVINCIAL CAPITAL OF NANGARHAR ( JALALABAD ),28540,11329,809,19,40697
60105,PROVINCIAL CAPITAL OF NANGARHAR ( JALALABAD ),13307,5219,513,101,19140
60106,PROVINCIAL CAPITAL OF NANGARHAR ( JALALABAD ),13795,4489,1422,5,19711
210101,PROVINCIAL CAPITAL OF BALKH ( MAZAR-E-SHARIF ),11566,8851,78,0,20495
210102,PROVINCIAL CAPITAL OF BALKH ( MAZAR-E-SHARIF ),5105,4688,31,0,9824
210103,PROVINCIAL CAPITAL OF BALKH ( MAZAR-E-SHARIF ),9411,3953,13,0,13377
210104,PROVINCIAL CAPITAL OF BALKH ( MAZAR-E-SHARIF ),5006,4098,328,0,9432
210105,PROVINCIAL CAPITAL OF BALKH ( MAZAR-E-SHARIF ),10338,9007,16,0,19361
210106,PROVINCIAL CAPITAL OF BALKH ( MAZAR-E-SHARIF ),5064,3460,3,0,8527
210107,PROVINCIAL CAPITAL OF BALKH ( MAZAR-E-SHARIF ),6960,6418,247,0,13625
210108,PROVINCIAL CAPITAL OF BALKH ( MAZAR-E-SHARIF ),6807,7632,33,0,14472
210109,PROVINCIAL CAPITAL OF BALKH ( MAZAR-E-SHARIF ),4269,4208,20,0,8497
210110,PROVINCIAL CAPITAL OF BALKH ( MAZAR-E-SHARIF ),8418,8394,9,0,16821
270101,PROVINCIAL CAPITAL OF KANDAHAR ( KANDAHAR ),38655,13456,358,0,52469
270102,PROVINCIAL CAPITAL OF KANDAHAR ( KANDAHAR ),38596,8241,1256,0,48093
270103,PROVINCIAL CAPITAL OF KANDAHAR ( KANDAHAR ),5295,1909,227,0,7431
270104,PROVINCIAL CAPITAL OF KANDAHAR ( KANDAHAR ),40920,5383,523,0,46826
270105,PROVINCIAL CAPITAL OF KANDAHAR ( KANDAHAR ),4834,751,937,0,6522
270106,PROVINCIAL CAPITAL OF KANDAHAR ( KANDAHAR ),6911,1058,47,0,8016
270107,PROVINCIAL CAPITAL OF KANDAHAR ( KANDAHAR ),10403,3063,179,0,13645
270108,PROVINCIAL CAPITAL OF KANDAHAR ( KANDAHAR ),11443,1123,461,0,13027
270109,PROVINCIAL CAPITAL OF KANDAHAR ( KANDAHAR ),24985,3591,200,0,28776
270110,PROVINCIAL CAPITAL OF KANDAHAR ( KANDAHAR ),36503,7885,1883,0,46271
270113,PROVINCIAL CAPITAL OF KANDAHAR ( KANDAHAR ),5334,571,55,0,5960
320101,PROVINCIAL CAPITAL OF HERAT (HERAT),6611,4660,5,0,11276
320102,PROVINCIAL CAPITAL OF HERAT (HERAT),2099,2289,0,0,4388
320103,PROVINCIAL CAPITAL OF HERAT (HERAT),8603,5068,22,0,13693
320104,PROVINCIAL CAPITAL OF HERAT (HERAT),3806,4502,14,0,8322
320105,PROVINCIAL CAPITAL OF HERAT (HERAT),16318,13587,10,0,29915
320106,PROVINCIAL CAPITAL OF HERAT (HERAT),9273,8571,24,0,17868
320107,PROVINCIAL CAPITAL OF HERAT (HERAT),10033,7492,37,0,17562
320108,PROVINCIAL CAPITAL OF HERAT (HERAT),8300,7094,51,0,15445
320109,PROVINCIAL CAPITAL OF HERAT (HERAT),6195,6340,2,0,12537
320110,PROVINCIAL CAPITAL OF HERAT (HERAT),6133,5523,83,0,11739
320111,PROVINCIAL CAPITAL OF HERAT (HERAT),7543,6145,60,0,13748
320112,PROVINCIAL CAPITAL OF HERAT (HERAT),10005,10765,14,0,20784
320113,PROVINCIAL CAPITAL OF HERAT (HERAT),9119,10031,5,0,19155
320114,PROVINCIAL CAPITAL OF HERAT (HERAT),2343,1886,7,0,4236
320115,PROVINCIAL CAPITAL OF HERAT (HERAT),2241,1032,39,0,3312
