ProvinceID,DistrictID,PollingCenterID,Center Name,Center Name,Hindu/Sikh,Nomad,Women,Men,Total
1,102,102298,مرکز آموزش قلعه بابو,Qalla e Babu Training Center,0,0,586,571,1157
1,102,102299,لیسه ابراهیم خیل,Ibrahim Khil High School,1,32,564,930,1527
1,102,102376,دفت ولسوالی پغمان,Paghman District Office,0,1,465,833,1299
1,102,102377,مکتب متوسطه عبدالله بن عمر,Abdullah Bin Omer Secondary School,0,18,277,444,739
1,102,102378,لیسه التقوا,Al Taqwa High School,0,0,1018,864,1882
1,102,102379,ليسه خواجه لکن,Khwaja Lakan High School,0,5,678,1176,1859
1,102,102380,لیسه ذکور پشه ئ,Pashayee Boys High School,0,13,404,1325,1742
1,102,102381,مکتب حسن البضي,Hassan ul Basari School,0,71,938,1980,2989
1,102,102382,ساحه کوچ ها,Saaha e Kochi ha (Kochis location),1,289,127,309,726
1,102,102383,کلینیک مرغگتان,Murghgeeran clinic,2,28,906,2759,3695
1,102,102384,مکتب متوسطه عمرفاروق,Omer Farouq Secondary School,0,85,518,929,1532
1,102,102385,مکتب حضت ابو بکر صديق,Hazrat Abubaker Sedique School,0,156,1070,2797,4023
1,102,102386,لیسه چهلی,Cheheltan High School,1,31,1113,1694,2839
1,102,102388,ليسه حضت خالد بن وليد,Hazrat Khalid Bin Waleed High School,0,3,1144,1656,2803
1,102,102389,مکتب متوسطه اوریاخیل,Oryakhil Secondary School,0,2,538,1604,2144
1,102,102390,مسجد خالداري,Khaldari Mosque,0,2,1074,2141,3217
1,102,102391,ليسه خواجه مسافر,Khwaja Musafir High School,1,6,1470,2970,4447
1,102,102392,مکتب ابتدائيه کشکک,Kashkak Primary School,0,27,948,3435,4410
1,102,102393,مکتب متوسطه پغمان قشنگ,Paghman e Qashang Secondary School,0,13,1162,1705,2880
1,102,102394,متوسطه الفلاح,Alfalah Secondary School,2,3,576,1200,1781
1,102,102395,لیسه قلعه ملک,Qalla e Malik High School,0,1,363,496,860
1,102,102396,ليسه عبدالله بن عباس,Abdullah Bin Abas High School,1,16,987,1382,2386
1,102,102397,مکتب ابتدائيه سموچک,Samochak Primary School,0,15,668,703,1386
1,102,102398,مکتب متوسطه حضت عثمان,Hazrat Usman Secondary School,0,16,666,812,1494
1,103,103399,مکتب ابتدائیه نسوان نو نیاز,Nawniaz Girls Primary School,1,418,957,1542,2918
1,103,103400,مسجد لیوان خیل,Lewan Khil Mosque,0,103,1398,1294,2795
1,103,103401,مسجد چهل دختان,Chehel Dukhtaran Mosque,0,6,599,1110,1715
1,103,103402,مسجد الیاس خیل,Ilyas Khil Mosque,0,8,1150,1107,2265
1,103,103403,مسجد حاچ مرجان,Haji Marjan Mosque,0,275,244,671,1190
1,103,103404,ليسه ملالی شهېد,Malalai Shaheed High School,1,153,709,2067,2930
1,103,103405,مسجد جامع ختآباد,Khairabad Jame Mosque,0,19,1176,1526,2721
1,103,103406,مسجد چارسوق,Chahar Souq Mosque,1,10,598,876,1485
1,103,103407,لیسه ذکور چهارآسیاب,Chahar Aasyab Boys High School,2,7,309,709,1027
1,103,103408,مکتب ابتدائیه قلعه لقمان,Qalla e Luqman Primary School,0,16,1165,1690,2871
1,103,103409,مکتب ابتدائیه ریشخور علیا,Reeshkhor Ulya Primary School,0,72,2343,3037,5452
1,103,103410,لیسه نسوان تنگ سعیدان,Tangi Sayeedan Girls High School,0,85,779,3362,4226
1,103,103411,کلینیک للندر,Lalandar clinic,2,101,1090,2170,3363
1,104,104412,لیسه ذکور بت خاک,Butkhak Boys High School,1,65,1642,2707,4415
1,104,104413,لیسه ویار احمدزی,Wyearr Ahmadzai High School,0,239,1581,2039,3859
1,104,104414,مسجد امام ابو حنیفه,Imam Abu Haneefa Mosque,0,161,741,1599,2501
1,104,104415,لیسه حسی خیل,Hussain Khil High School,0,249,1628,3278,5155
1,104,104416,لیسه ذکور شينه,Sheena Boys High School,1,68,162,970,1201
1,104,104417,لیسه نسوان شینه,Sheena Girls High School,0,7,799,853,1659
1,104,104418,لیسه عبدالشکور رشاد,Abdul Shukoor Reshad High School,1,279,1698,3753,5731
1,104,104419,لیسه نسوان قلعه احمد خان,Qalla e Ahmad Khan Girls High School,0,7,474,721,1202
1,104,104420,لیسه قلعه نعمان,Qalla e Noman High School,0,35,555,1100,1690
1,104,104421,لیسه نسوان قلعه وزیر,Qalla e Wazeer Girls High School,0,12,1166,2846,4024
1,104,104422,مکتب متوسطه شهید محمد عارف ظری,Shaheed Mohammad Arif Zareef Secondary School,0,62,1732,2289,4083
1,104,104424,لیسه ذکور شیوکی,Shewaki Boys High School,1,51,2242,3474,5768
1,104,104425,مسجد جامع قلعه حسن خان,Qalla e Hassan Khan Jame Mosque,2,248,1576,2669,4495
1,104,104426,لیسه شهید ملک گلرحمن,Shaheed Malik Gul Rahman High School,0,113,1556,4007,5676
1,104,104427,لیسه نسوان کمری,Kamari Girls High School,2,112,899,2219,3232
1,104,104428,مکتب ابتدائيه کاريز بکر,Karez Bakar Primary School,2,929,1239,4241,6411
1,104,104557,مسجد سفید حضت بلال,Hazrat Belal White Mosque,5,1691,2590,5694,9980
1,104,104558,مکتب شهید شمالی,Shahid Shamali School,1,3614,489,2363,6467
1,104,104423,لیسه ذکور سهاک,Zahoor Sahak Boys High School,3,47,1702,4648,6400
1,105,105429,مسجد جامع کاکړ,Kakarr Jame Mosque,1,95,774,1103,1973
1,105,105430,مسجد قیس و لونگ,Qais wa Lawang Mosque,1,303,1036,2715,4055
1,105,105431,متوسطه ده ست خاص,Deh Sabz Khas Secondary School,1,320,1756,2014,4091
1,105,105432,متوسطه خواجه غار,Khwaja Ghar Secondary School,1,2,581,2348,2932
1,105,105433,لیسه نسوان ده ست خاص,Deh Sabz Khas Girls High School,0,33,1115,2358,3506
1,105,105434,مکتب حرفوی بابه قشقار,Baba Qashqar vocational School,0,3,510,1740,2253
1,105,105435,لیسه آبدره,Aabdara High School,0,15,1516,2404,3935
1,105,105436,مکتب متوسطه شیخو,Shiekho Secondary School,0,131,1055,3437,4623
1,105,105437,متوسطه شیخ سعدالدین محمد انصاری,Shiekh Saduddin Mohammad Ansari Secondary School,0,70,552,758,1380
1,105,105438,مسجد شیف ملک زرګل,Malik Zargul Mosque,159,13,232,614,1018
1,105,105439,لیسه خواجه چشت,Khwaja Chesht High School,1,70,937,2467,3475
1,105,105440,مکتب ذکور پاچا صاحب,Pacha Sahib Boys School,1,0,500,839,1340
1,105,105441,ليسه ده يحی,Deh Yahya High School,1,3,823,1599,2426
1,105,105442,مسجد شیف حاچ احمد شاه,Haji Ahmad Shah Mosque,1,122,232,325,680
1,105,105443,کلینک صحی پل سنگ,Pul e Sangi Health Clinic,0,16,514,1115,1645
1,105,105444,لیسه نسوان تره خیل,Tarakhil Girls High School,2,2,1430,2012,3446
1,106,106445,مکتب متوسط کوچ,Kochi Secondary School,1,743,210,209,1163
1,106,106446,مسجد شهرک الغوی,Shahrak Ulghoi Mosque,3,683,499,488,1673
1,106,106447,لیسه دانشمند,Danishmand High School,0,122,866,1659,2647
1,106,106448,لیسه محمدحسن خان,Mohammad Hassan Khan High School,1,33,1099,2140,3273
1,106,106449,ليسه قلعه مراد بيک,Qalla e Murad Baig High School,0,6,1383,2812,4201
1,106,106450,مکتب ابتدائيه حاچ پيک,Haji Paik Primary School,0,1,781,1560,2342
1,106,106451,ليسه بويه زار,Boya Zar High School,1,10,1059,2544,3614
1,106,106452,کلينيک بهزادي,Behzadi Clinic,1,0,220,1166,1387
1,106,106453,ليسه شکردره,Shakardarah High School,1,2,1060,2207,3270
1,106,106454,ليسه دره شکردره,Darah e Shakardarah High School,0,14,802,1528,2344
1,106,106455,ليسه غازه,Ghaza High School,1,68,1628,2704,4401
1,106,106456,مکتب متوسطه بالا کاريز,Bala Karez Secondary School,1,0,869,1157,2027
1,106,106457,مکتب متوسطه وزیرگل شهید,Wazeer Gul Shaheed Secondary School,0,19,878,1167,2064
1,106,106458,ليسه حضت عثمان,Hazrat Usman High School,1,238,2670,3852,6761
1,107,107459,مسجد جامع قریه شینگ دشتک,Shenkai Dashtak Village Jame Mosque,0,67,2926,2274,5267
1,107,107460,مکتب متوسطه قشلاق,Qeshlaq Secondary School,0,77,1144,1636,2857
1,107,107461,مسجد عباس قل,Abas Quli Mosque,1,661,1437,1433,3532
1,107,107462,مسجد سنگ نوشته,Sang e Naweshta Mosque,2,321,2257,1446,4026
1,107,107463,مکتب متوسطه نسوان قلعه جانان,Qalla E Janan Girls Secondary School,1,0,574,1523,2098
1,107,107464,مکتب متوسطه رحمت آباد,Rahmat Abad Secondary School,0,149,0,989,1138
1,107,107465,لیسه موسهی علیا,Mosahi Ulya High School,1,0,574,1718,2293
1,107,107466,کلینیک میاخیل,Miakhil Clinic,0,9,1044,1570,2623
1,107,107467,نسوان ابتدائيه موسهی,Mosahi Girls Primary School,0,2,77,1161,1240
1,108,108468,مکتب مت بچه کوت,Mir Bacha Kot School,1,1,778,1962,2742
1,108,108469,لیسه نمت ۲ متبچه خان,Mir Bacha Khan High School No. 2,0,1,617,1339,1957
1,108,108470,مسجد جامع ماریگ,Mareki Jame Mosque,0,0,321,1169,1490
1,108,108471,هواشناش,Hawashinasi (Meteorology),0,0,207,388,595
1,108,108472,مکتب ابتدایه قلم چاق,Qalam Chaq Primary School,0,19,473,560,1052
1,108,108473,مکتب مشوائ,Mashwanni School,0,40,552,417,1009
1,108,108474,مسجد بابه قشقار,Baba Qashqar Mosque,1,0,781,1115,1897
1,108,108475,مکتب متوسطه شیخان,Shiekhan Secondary School,0,11,705,1177,1893
1,108,108476,مکتب متوسطه دکو,Dako Secondary School,0,0,509,1476,1985
1,108,108477,مکتب مت حميدالله,Mir Hamidullah School,8,1,1641,2307,3957
1,108,108478,مکتب پل صوفيان,Pul e Sofyan School,0,12,472,1427,1911
1,108,108479,مکتب متوسطه آبچکان,Aabchakan Secondary School,1,14,584,1392,1991
1,109,109480,مکتب ابتدائيه غزکی,Ghazgai Primary School,0,118,1089,1082,2289
1,109,109481,لیسه ذکور چکری,Chakari Boys High School,0,15,1153,1121,2289
1,109,109482,مسجد جامع بر ملنگ,Bar Malang Jame Mosque,0,65,1099,1142,2306
1,109,109483,مکتب متوسطه ولی خان,Wali Khan Secondary School,0,17,1032,1144,2193
1,109,109484,مسجد جامع خورد کابل,Khord Kabul Jame Mosque,2,8,1179,1163,2352
1,109,109485,مکتب ابتدائیه ملاعمر,Mullah Omer Primary School,0,314,1603,1583,3500
1,109,109486,مکتب ابتدائیه چنار,Chinar Primary School,0,148,1073,1107,2328
1,110,110487,مکتب متوسطه زمه,Zamah Secondary School,0,2,729,997,1728
1,110,110488,مکتب آقا شاي,Aqa Sarai School,0,7,680,730,1417
1,110,110489,مکتب متوسطه مقاومت,Moqawomat Secondary School,0,3,227,379,609
1,110,110490,ليسه امت حبيب الله شهيد,Amir Habibullah Shaheed High School,1,0,870,1831,2702
1,110,110491,مکتب سواد حيائ,Sewad Hayati School,0,1,480,625,1106
1,110,110492,لیسه قحی,Qechi High School,0,13,507,574,1094
1,110,110493,لیسه کارنده,Karendah High School,0,3,383,923,1309
1,110,110494,مکتب متوسطه مشوائ,Mashwanni Secondary School,0,0,794,1088,1882
1,110,110560,لیسه مت درویش کوهدامن,Mir Darwish Kohdamani High School,0,14,148,1926,2088
1,111,111495,لیسه دشت گلدره,Dasht e Guldarah High School,0,37,867,1394,2298
1,111,111496,ابتدائیه قول افغان,Qul Afghan Primary School,0,3,303,461,767
1,111,111497,لیسه پیام آزادی,Payam E Azadi High School,0,9,824,1301,2134
1,111,111498,مکتب ده عربان,Deh e Araban School,0,5,584,479,1068
1,111,111499,مسجد گدره,Gedrah Mosque,0,1,370,335,706
1,111,111500,مکتب خراسان,Khurasan School,0,43,929,501,1473
1,112,112501,مسجد قلعه مقرب,Qalla e Moqarab Mosque,1,10,571,526,1108
1,112,112502,مسجد حسن خيل,Hasan Khil Mosque,0,3,561,381,945
1,112,112503,مسجد زرکران,Zargaran Mosque,0,0,0,1211,1211
1,112,112504,لیسه ذکور فرزه,Farzah Boys High School,0,0,622,1290,1912
1,112,112505,مکتب قلعه متا فغان,Qalla e Mir Afghan School,1,0,1143,861,2005
1,112,112506,مسجد قلعه چنار,Qalla e Chinar Mosque,1,0,358,701,1060
1,112,112507,مسجد جامع,Jame Mosque,0,5,578,974,1557
1,112,112508,مسجد شخان خیل,Sar Khan Khil Mosque,0,0,293,311,604
1,113,113509,مکتب ابتدائيه خواجه حسن,Khwaja Hasan Primary School,1,0,492,972,1465
1,113,113510,لسیه شهید احمد شاه مسعود,Shaheed Ahmad Shah Masoud High School,0,5,849,1031,1885
1,113,113511,مسجد نور علم,Noor Alam Mosque,0,0,577,1283,1860
1,113,113512,لیسه مولوی محمد يعقوب شاه,Mawlawi Mohammad Yaqoub Shah High School,0,6,862,1744,2612
1,113,113513,ليسه استالف,Istalif High School,0,2,1014,1715,2731
1,113,113514,ليسه بدل شاه خيل,Badal Shah Khil High School,0,76,721,826,1623
1,114,114515,دارالمعلمی قره باغ,Qarabagh Teacher Training Center,2,9,791,2563,3365
1,114,114516,ليسه عبدالوکيل شهيد,Abdul Wakeel Shaheed High School,0,9,562,2444,3015
1,114,114517,مکتب متوسطه قلعه حاچ,Qalla e Haji Secondary School,1,20,695,974,1690
1,114,114518,لیسه ست سنگ,Sabz Sang High School,0,10,613,1911,2534
1,114,114519,مکتب متوسطه باغ عارق,Bagh e Aareq Secondary School,1,0,534,978,1513
1,114,114520,لیسه عالی داودزي,Daudazai High School,0,120,922,1615,2657
1,114,114521,مسجد جامع لنگر,Langar Jame Mosque,0,2,1065,1735,2802
1,114,114522,لیسه السغان,Alsaghan High School,2,102,1069,3692,4865
1,114,114523,مسجد جامع چاوئ,Chawnni Jame Mosque,0,225,513,2086,2824
1,114,114524,لیسه باغ علم,Bagh Alam High School,0,28,1102,2328,3458
1,114,114525,مکتب متوسطه جارچ,Jarchi Secondary School,2,32,1678,2333,4045
1,114,114526,لیسه متعلم خان,Mir Alam Khan High School,1,337,1216,1833,3387
1,114,114527,مسجد جامع کاریز مت,Kariz Mir Jame Mosque,0,0,339,725,1064
1,114,114528,مکتب متوسطه عبدالرحمان بابا,Abdul Rahman Baba Secondary School,0,3,574,1296,1873
1,114,114529,مکتب متوسطه اکا خيل,Aka Khil Secondary School,0,8,1132,2089,3229
1,114,114530,متوسطه لنگر,Langar secondary School,1,14,189,1121,1325
1,114,114531,لیسه استغچ,Isterghech High School,1,88,883,2175,3147
1,115,115532,کلينيک شوئ,Surobi clinic,1,4,1161,2330,3496
1,115,115533,مکتب ابتدائيه شهرک,Shahrak Primary School,1,5,352,1936,2294
1,115,115534,ليسه هوتخیل بالا,Hotk Khil Bala High School,1,99,1311,2194,3605
1,115,115535,مکتب متوسطه نسوان هوتخیل,Hotk Khil Girls Secondary School,0,59,105,398,562
1,115,115536,مسجد جامع دره حصاره,Darah e Hesar Jame Mosque,0,9,1136,1383,2528
1,115,115537,متوسطه نسوان شچشمه,Sarchashma Girls Secondary School,0,9,1773,2294,4076
1,115,115538,مسجد شت خان کچ,Sher Khan Kas Mosque,0,18,578,843,1439
1,115,115539,مکتب گوگا مندا,Goga Monda School,0,46,491,835,1372
1,115,115540,مکتب تورکائ,Toorkanai School,1,12,1558,1125,2696
1,115,115543,مکتب جگدلک,Jigdalak School,1,193,1172,2148,3514
1,115,115545,مکتب سپت کوندی,Sperkundai School,3,40,1172,1721,2936
1,115,115546,مکتب رودبار,Rodbar School,0,116,592,1061,1769
1,115,115547,مکتب قلعه کلان,Qalla e Kalan School,1,108,1109,1082,2300
1,115,115548,مسجد بام دړي,Baam Darrai Mosque,2,154,1062,1603,2821
1,115,115549,مکتب گاز علیا,Gaz Ulya School,1,168,1069,861,2099
1,115,115550,مکتب یخدند,Yakhdand School,1,81,1742,2230,4054
1,115,115551,لیسه حسی خیل,Husain Khil High School,1,536,1922,4607,7066
1,115,115552,مکتب وکه خاص,Waka Khas School,2,20,1097,1121,2240
1,115,115553,مکتب متوسطه نغلو,Naghloo Secondary School,1,5,899,1694,2599
1,115,115544,مسجد میارسول بابا,Mia Rasoul Baba Mosque,0,2,586,1754,2342
1,10102,101017,مکتب قاري عبدالله,Qari Abdullah School,0,0,207,338,545
1,10102,101018,مسجد جامع حضت نبوی,Hazrat Nabawi Jame Mosque,4,4,579,1497,2084
1,10102,101019,لیسه انصاری,Ansari High School,1,1,1092,2439,3533
1,10102,101020,مسجد رنگه,Ranga Mosque,1,0,235,946,1182
1,10102,101021,انستیتیوت مسلکی تجارت,Trade technical Institute (Institute Maslaki Teja*,0,3,237,1472,1712
1,10102,101022,زیارت ابوالفضل,Zyarat Abul Fazal,2,14,85,987,1088
1,10102,101023,ليسه استقلال,Isteqlal High School,1,8,303,1960,2272
1,10102,101024,مسجد نایب سالار,Nayeb Salar Mosque,4,4,826,2508,3342
1,10102,101025,مسجد امام اعظم,Imam Azam Mosque,0,1,549,776,1326
1,10102,101026,لیسه عالی ذبیح الله شهید,Zabihullah Shaheed High School,1,3,890,2777,3671
1,10102,101027,مسجد سعد بن ائ وقاص,Sa'ad bin Abi Waqas Mosque,0,0,368,621,989
1,10102,101028,مکتب متوسطه وزير محمد اکت خان,Wazeer Mohammad Akbar Khan Secondary School,1,1,463,1058,1523
1,10102,101029,ليسه نادريه,Naderia High School,5,29,621,3020,3675
1,10102,101030,مسجد عمر فاروق,Omer Farooq Mosque,0,1,661,2044,2706
1,10102,101031,مسجد معاذ ابن جبل,Ma'az ibne Jabal Mosque,0,1,284,625,910
1,10102,101032,مسجد عبدالله بن مسعود,Abdullah bin Masoud Mosque,1,5,370,1635,2011
1,10103,101033,مکتب متوسطه تجربوی سید جمال الدی,Sayed Jamaluddin Experimental Secondary School,1,0,381,707,1089
1,10103,101034,انستیتوت تکنالوژی افغان,Afghan Technology Institute,0,0,273,1550,1823
1,10103,101035,مکتب متوسطه سید جمال الدین,Sayed Jamaluddin Secondary School,1,1,972,2216,3190
1,10103,101036,لیسه رابعه بلحی,Raabia Balkhi High School,0,3,1096,1693,2792
1,10103,101037,مکتب امت دوست محمد خان,Amir Dost Mohammad Khan School,0,3,513,1624,2140
1,10103,101038,مسجد حنظله,Hanzalla Mosque,0,0,332,667,999
1,10103,101039,مکتب متوسطه امت حمزه,Amir Hamza Secondary School,4,0,559,1686,2249
1,10103,101040,مسجد محمدیه,Mohammadia Mosque,0,1,533,1272,1806
1,10103,101041,مکتب متوسطه نمت١٣ جمال مينه,"Jamal Mena, no. 13 Secondary School",0,0,990,1130,2120
1,10103,101042,مکتب ابتدایه نمت 12 جمال مینه,"Jamal Mena, no. 12 Preliminary School",2,0,1355,2819,4176
1,10103,101043,پوهنحی حقوق,Legal Faculty (Pohanzai Huqooq),0,4,822,2335,3161
1,10103,101044,لیسه درخائ,Durkhanai High School,0,2,1087,1846,2935
1,10103,101045,مسجد سنگ کشان,Sang Kashan Mosque,0,0,171,968,1139
1,10103,101046,مکتب صوف اسلام,Sufi Islam School,1,8,1909,3456,5374
1,10103,101047,لیسه محمود هوتگ,Mahmood Hotaki High School,1,17,840,4162,5020
1,10104,101048,مکتب نمت ۱ غازی محمد ایوب,Ghazi Mohammad Ayub School no.1,142,9,700,1290,2141
1,10104,101049,ليسه رابيا,Raabia High School,1,13,1264,1911,3189
1,10104,101050,مسجد حاچ غلام دستگت,Haji Ghulam Dastagir Mosque,0,2,593,1739,2334
1,10104,101051,مسجد امام رضاي غريب,Imam Reza e Ghareeb Mosque,1,5,519,805,1330
1,10104,101052,لیسه محمد اعلم فیض زاد,Mohammad Alam Faizzad High School,0,2,578,1452,2032
1,10104,101053,لیسه جمهویت,Jamhoriat High School,0,1,222,656,879
1,10104,101054,لیسه نسوان ملالی,Malalai Girls High School,1,2,294,1628,1925
1,10104,101055,مسجد خواجه عبدالله انصاري,Khwaja Abdullah Ansari Mosque,0,3,113,802,918
1,10104,101056,مسجد خواجه عل موفق,Khwaja Ali Mowafaq Mosque,0,2,275,2105,2382
1,10104,101057,مسجد حاچ محمد داد,Haji Mohammad Dad Mosque,1,6,1075,2476,3558
1,10104,101058,مکتب متوسطه ناصر خسرو بلحی,Naser Khesraw Balkhi Secondary School,0,29,461,1248,1738
1,10104,101059,جماعت خانه اسماعيليه,Ismaelia Jamat Khana,0,4,2577,4630,7211
1,10104,101060,لیسه استاد مصباح,Ustad Misbah High School,0,65,859,2295,3219
1,10104,101062,ليسه نسوان تاجور سلطانه,Tajwar Sultana Girls School,0,116,2006,2692,4814
1,10104,101063,مکتب محمد صدیق فرهنگ,Mohammad Sediq Farhang School,3,43,995,2194,3235
1,10104,101064,لیسه نسوان ده کیپک,Deh Keepak Girls School,0,1,813,2025,2839
1,10104,101061,مکتب نسوان ملکه ثریا,Malika Suraya Girls School,0,38,3285,4257,7580
1,10105,101065,مکتب متوسطه فاضل بيک,Fazel Baig Secondary School,1,17,731,2448,3197
1,10105,101066,مسجد شهدای فاضل بیک,Shuhadai Fazel Baig Mosque,0,0,362,1360,1722
1,10105,101067,مسجد حضت عثمان,Hazrat Usman Mosque,0,11,530,2185,2726
1,10105,101068,مسجد اتفاق,Itefaq Mosque,0,68,391,1263,1722
1,10105,101069,مسجد جامع حاچ یعقوب,Haji Yaqoub Jame Mosque,2,30,573,1586,2191
1,10105,101070,ليسه ناهيد شهيد,Naheed Shaheed High School,0,24,1586,2086,3696
1,10105,101071,لیسه محمد اسماعیل حسن زی,Mohammad Ismael Hasanzai High School,0,6,977,2286,3269
1,10105,101072,لیسه متغلام محمد غبار,Mir Ghulam Mohammad Ghubar High School,0,12,378,1849,2239
1,10105,101073,مسجد محمدي دارالحفاظ,Mohammadi Darulhefaz Mosque,0,5,515,2082,2602
1,10105,101074,مسجد وردکيها,Wardaki ha Mosque,0,19,975,2736,3730
1,10105,101075,مسجد امام حسی,Imam Hussain Mosque,0,45,477,964,1486
1,10105,101076,لیسه نسوان سپی کل,Speen Kalai Girls High School,2,6,1086,1819,2913
1,10105,101077,لیسه حضت شمس المشایخ,Hazrat Shamsul Mashaikh High School,0,25,816,2151,2992
1,10105,101078,لیسه پروفیسور رسول امی,Prof. Rasoul Amin High School,0,2,584,1294,1880
1,10105,101079,مسجد پولی تخنيک,Polytechnic Mosque,2,1,305,1829,2137
1,10105,101080,مسجد جاغوري ها,Jaghori ha Mosque,0,3,1320,1803,3126
1,10105,101081,مسجد صاحب زمان,Sahib Zaman Mosque,1,1,1316,2090,3408
1,10105,101082,ليسه ابوذر غفاري,Abu Zar Ghafari High School,0,16,2153,3826,5995
1,10105,101083,مسجد ايوب صابر,Ayub Saber Mosque,3,228,1619,4631,6481
1,10105,101084,مکتب ده عربان,Deh e Araban School,0,7,1138,1641,2786
1,10105,101085,مسجد شاه اوليا,Shah e Awlya Mosque,0,8,344,710,1062
1,10105,101086,مسجد حضت بلال,Hazrat Bilal Mosque,0,51,0,2176,2227
1,10105,101087,مسجد حضت محمد ص,Hazrat Mohammad (pbuh) Mosque,0,145,1017,2168,3330
1,10105,101088,ليسه قلعه کاشف,Qalla e Kashif High School,0,843,1704,5747,8294
1,10105,101089,مسجد شهيد,Shaheed Mosque,0,42,578,2265,2885
1,10106,101090,ليسه نسوان ش آسياب,Sar Aasyab Girls High School,0,6,1001,1204,2211
1,10106,101091,مسجد شاه ولايت ماب,Shah E Welayat Ma'ab Mosque,1,21,714,1210,1946
1,10106,101092,لیسه قلعه بختیار,Qalla e Bakhtyar High School,0,8,1174,2218,3400
1,10106,101093,انستيتوت توبرکلوز,Tuberculosis Institute,0,1,704,735,1440
1,10106,101094,انستیتوت مالی و حسائ,Finance and Accounting Institute (Mali wa Hesabi *,0,4,575,1406,1985
1,10106,101095,مسجد جعفريه,Jafaria Mosque,0,0,985,1095,2080
1,10106,101096,مسجد محمديه,Mohammadia Mosque,0,9,938,2206,3153
1,10106,101097,ليسه عبدالغن مستغن,Abdul Ghani Mostaghni High School,0,2,411,1049,1462
1,10106,101098,مرکز ناحيه ششم,Markaz Nahia e Shashum (Nahia 6 Center),2,43,127,491,663
1,10106,101099,مدرسه رسالت,Resalat Madrassah,1,0,1629,1758,3388
1,10106,101100,مسجد سفيد,Safed Mosque (White Mosque),4,3,2326,2207,4540
1,10106,101101,مسجد احمدي,Ahmadi Mosque,1,0,2080,3457,5538
1,10106,101102,تکيه خانه وحدت,Wahdat Takya Khanahh,1,1,1076,1514,2592
1,10106,101103,لیسه ام البنی,Ummul Baneen High School,0,0,1758,2003,3761
1,10106,101104,مدرسه جامعۀ الاسلام,Jamia Al Islam Madrassah,0,1,830,715,1546
1,10106,101105,مسجد جامع ولی عض,Wali Aser Jame Mosque,0,0,964,1180,2144
1,10106,101106,ليسه محمد آصف مايل,Mohammad Asef Mael High School,1,0,743,1316,2060
1,10106,101107,مدرسه خاتم الانبيا,Khatemul Anbya Madrassah,0,0,754,1153,1907
1,10106,101108,مکتب متوسطه گلخانه,Gul Khana Secondary School,0,0,1474,1785,3259
1,10106,101109,مسجد حضت رسول,Hazrat e Rasoul Mosque,0,1,625,596,1222
1,10106,101110,مسجد نن اکرم,Nabi Akram Mosque,2,5,1290,2347,3644
1,10106,101111,مسجد قايم آل محمد,Qayem Aale Mohammad Mosque,0,0,1534,1686,3220
1,10106,101112,مسجد شور کائنات,Sarwar e Kainat Mosque,1,4,734,1077,1816
1,10106,101113,ليسه چهار قلعه,Chahar Qalla High School,0,0,1095,2735,3830
1,10106,101114,مدرسه باقرالعلوم,Baqer ul Uloom Madrassah,0,1,665,2394,3060
1,10106,101115,مسجد سلمان فارش,Salman e Farsi Mosque,1,5,2717,2194,4917
1,10106,101116,لیسه صق الله افضل,Safiullah Afzali High School,0,50,395,926,1371
1,10107,101117,مسجد لیث بن قیس,Lais Bin e Qais Mosque,0,0,127,289,416
1,10107,101118,ليسه فاميل هاي ريش خور,Family Haee Reeshkhor High School,1,1,1477,2218,3697
1,10107,101119,مسجد احمدیه قلعه فتوح,Qalla e Fatoh Ahmadia Mosque,1,13,888,1582,2484
1,10107,101120,ليسه غازي عبدالله,Ghazi Abdullah High School,0,1,628,1498,2127
1,10107,101121,مسجد جامع ابراهیم خلیل,Ibrahim Khalil Jame Mosque,0,16,1687,3593,5296
1,10107,101123,مسجد عيد گاه,Eidgah Mosque,1,32,533,1464,2030
1,10107,101124,ليسه نسوان غازي ادي,Ghazi Ade Girls High School,0,0,1292,2311,3603
1,10107,101125,انستیتوت تخنيگ,Technical Institute,0,13,568,2107,2688
1,10107,101126,ليسه عمرا خان,Omara Khan High School,0,1,827,1727,2555
1,10107,101127,مسجد حضت نبوي,Hazarat E Nabawi Mosque,0,2,893,2015,2910
1,10107,101128,لیسه عالی آقا عل شمس,Aaqa Ali Shams High Shool,0,1,1980,2901,4882
1,10107,101129,ليسه نسوان سلطان راضيه,Sultan Razia Girls High School,1,4,1902,2018,3925
1,10107,101130,ليسه نسوان ايمين,Aemeni Girls High School,0,1,932,1303,2236
1,10107,101131,ليسه خوشحال خان,Khushal Khan High School,0,2,302,1720,2024
1,10107,101132,مکتب متوسطه نسوان گذرگاه,Guzargah Girls Secondary School,1,6,989,1739,2735
1,10107,101133,ليسه نسوان گذرگاه,Guzargah Girls High School,0,0,184,300,484
1,10107,101134,لیسه حبیبیه,Habibia Girls High School,0,12,811,3465,4288
1,10107,101135,مسجد ايوب خان,Ayub Khan Mosque,1,23,460,946,1430
1,10107,101136,لیسه نسوان شدار کابل,Sardar e Kabuli Girls High School,1,5,3351,3876,7233
1,10107,101137,مسجد محمدیه,Mohammadia Mosque,2,1,679,970,1652
1,10107,101138,مکتب متوسطه عطاالله فیضائ,Ataullah Faizani Secondary School,1,1,598,802,1402
1,10107,101139,ليسه نسوان ده دانا,Deh Dana Girls High School,1,5,1908,2871,4785
1,10107,101140,لیسه محراب الدین,Mehrabuddin High School,0,15,1660,3855,5530
1,10107,101122,ليسه نسوان چهلستون,Chehlsutoon Girls High School,0,10,1265,1857,3132
1,10108,101141,لیسه عبدالرحمن پژواک,Abdul Rahman e Pazhwak High School,2,101,1699,3986,5788
1,10108,101142,لیسه ذبیح الله عصمن,Zabihullah Esmati High School,0,58,1085,1955,3098
1,10108,101144,مسجد زاخیل و مهمند,Zakhil wa Mohmand Mosque,3,458,993,2029,3483
1,10108,101145,مسجد حضور حضت نن,Huzoor Hazrat Nabi Mosque,0,11,582,2283,2876
1,10108,101146,مسجد حضت بلال,Hazarat Bilal Mosque,2,410,936,1742,3090
1,10108,101147,مسجد عمر فاروق,Omer Farooq Mosque,0,39,394,1098,1531
1,10108,101148,مسجد احمدي,Ahmadi Mosque,0,28,1144,2882,4054
1,10108,101149,مسجد غوث اعظم دستگت,Ghaws Azam Dastagir Mosque,0,23,546,1716,2285
1,10108,101150,مسجد عبد القادر جیلائ,Abdul Qader Jailani Mosque,0,11,889,1728,2628
1,10108,101151,مسجد محمدیه سیدنورمحمد شاه,Sayed Noor Mohammad Shah Mohamadia Mosque,0,64,1150,4579,5793
1,10108,101152,لیسه توتیا,Totya High School,1,4,1585,1752,3342
1,10108,101153,لیسه نسوان سید نورمحمد شاه مینه,Sayed Noor Mohammad Shah Mena Girls High School,0,114,880,1989,2983
1,10108,101154,ليسه نسوان رحمن مينه,Rahman Mena Girls High School,0,35,2635,4453,7123
1,10108,101155,لیسه ذکور سید نورمحمد شاه مینه,Sayed Noor Mohammad Shah Mena Boys High School,0,62,934,1609,2605
1,10108,101156,مسجد رنگه,Ranga Mosque,0,4,507,1689,2200
1,10108,101157,ليسه عبدالحی حبين,Abdul Hai Habibi High School,1,54,1341,2896,4292
1,10108,101158,مسجد ابوبکر صدیق,Abubakar Sedique Mosque,1,10,723,1574,2308
1,10108,101159,مسجد عثمان غن,Usman Ghani Mosque,1,5,864,2005,2875
1,10108,101160,مسجد شاه پاچا,Shah Pacha Mosque,0,10,393,742,1145
1,10108,101161,مسجد شک اول,Sarak e Awal Mosque,2,8,1031,2100,3141
1,10108,101162,مسجد جامع شهرک طلائ,Shahrak e Telayee Mosque,3,8,578,1169,1758
1,10108,101163,مکتب شهید عبدالصبورفرید,Shaheed Abdul Sabour Fareed School,0,1,638,1093,1732
1,10108,101164,لیسه عبدالرحیم غفورزی,Abdul Rahim Ghafourzai High School,0,28,208,1416,1652
1,10108,101165,ليسه نسوان آمينه فدوي,Amena Fidawi Girls High School,0,16,1707,2669,4392
1,10108,101166,مسجد تپه بلخ,Tapah e Balkh Mosque,0,25,828,2304,3157
1,10108,101167,ليسه استاد بيتاب,Ustad Betab High School,0,12,480,1633,2125
1,10108,101168,مسجد اصحاب کرام,Ashab e Keram Mosque,0,40,404,1316,1760
1,10108,101169,لیسه قلعه حشمت خان,Qalla e Hashmat Khan High School,0,15,1376,1062,2453
1,10108,101170,متوسطه قلعه حشمت خان,Qalla e Hashmat Khan Secondary School,0,87,549,2819,3455
1,10108,101171,الحاقیه نمت یک لیسه عبدالحی حن,Ilhaqya no.1 Abdul Hai Habibi High School,1,20,762,1712,2495
1,10109,101172,مسجد نور محمد,Noor Mohammad Mosque,0,12,348,1582,1942
1,10109,101173,مکتب متوسطه پکتيا کوت,Paktya Kot Secondary School,0,108,1105,4165,5378
1,10109,101174,لیسه عل احمد خان پوپل,Ali Ahmad Khan Popal High School,0,14,3116,4816,7946
1,10109,101175,لیسه عالی قابل بای,Qabil Bye High School,0,8,852,4797,5657
1,10109,101176,مکتب متوسطه خواجه رواش,Khwaja Rawash Secondary School,0,6,729,1696,2431
1,10109,101177,مسجد لغمائ ها,Laghmani Ha Mosque,0,25,1090,2692,3807
1,10109,101178,بلاک اول رياست هوا شناش,Block Awal Reyasat Hawa Shinasi (Block no. 1 Mete*,1,11,885,2281,3178
1,10109,101179,مسجد منصور هلاج,Mansour Halaaj Mosque,2,1,677,1530,2210
1,10109,101180,شهید شدار محمد داود خان,Shaheed Sardar Mohammad Daud Khan Mosque,0,9,2009,2392,4410
1,10109,101181,انستیتوت تکنالوژی معلومائ و مخا,IT and Telecommunications Institute,0,1,100,368,469
1,10109,101182,مسجد حضت محمد مصطق,Hazrat Mohammad Mustafa Mosque,1,3,508,1468,1980
1,10109,101184,لیسه حاچ عبدالقدیر,Haji Abdul Qadeer High School,0,0,221,575,796
1,10109,101185,ليسه ابوالقاسم فردوش,Abul Qasem Firdousi High School,0,3,1172,1147,2322
1,10109,101186,لیسه ذکور ئ ئ مهرو,Bibi Mahro Boys High School,0,1,295,1543,1839
1,10109,101187,ليسه عبدالهادي داوي,Abdul Hadi Dawi High School,0,3,723,2386,3112
1,10109,101188,مسجد جامع شف شش درک,Shash Darak Sharqi Jame Mosque,1,2,142,882,1027
1,10109,101189,لیسه ستاره,Setara High School,0,5,125,1506,1636
1,10109,101183,ليسه الفتح,Al Fatah High School,2,6,1677,2800,4485
1,10110,101190,وزارت امور زنان,Ministry of Women Affairs,0,0,104,282,386
1,10110,101191,معینیت سواد آموزی,Moenyat Sewad Amozi (Deputy Ministry for Literacy),0,0,50,665,715
1,10110,101192,لیسه عالی امائ,Amani High School,0,0,87,645,732
1,10110,101193,مسجد وزير اکت خان,Wazeer Akbar Khan Mosque,0,3,226,2280,2509
1,10110,101194,مسجد احمد مجتن,Ahmad Mujtaba Mosque,0,7,152,796,955
1,10110,101195,مسجد جعفري,Jafari Mosque,0,1,591,987,1579
1,10110,101196,مسجد ميدان ئ ئ مهرو,Bibi Mahro Maidan Mosque,0,2,720,2116,2838
1,10110,101197,ليسه نسوان ئ ئ مهرو,Bibi Mahro Girls High School,0,8,1422,1053,2483
1,10110,101198,مکتب متوسطه عزيز افغان,Aziz Afghan Secondary School,0,1,526,1204,1731
1,10110,101199,مسجد حضت داود,Hazrat Daoud Mosque,0,6,387,773,1166
1,10110,101200,مسجد قلعه چمن,Qalla e Chaman Mosque,0,12,352,1208,1572
1,10110,101201,مسجد جامع شهرک,Shahrak Jame Mosque,0,0,583,960,1543
1,10110,101202,مسجد اسبق حضت عمر فاروق,Hazrat Omer Farouq Old Mosque,1,0,925,1048,1974
1,10110,101203,مسجد حضت يوسف,Hazrat Yousuf Mosque,1,11,793,1416,2221
1,10110,101204,مسجد سيد نظام,Sayed Nezam Mosque,0,0,1366,1173,2539
1,10110,101205,مسجد شیتی ها,Shebari Ha Mosque,1,2,2070,1506,3579
1,10110,101206,مسجد خواجه پارسا ولی,Khwaja Parsa e Wali Mosque,0,0,197,546,743
1,10110,101207,مسجد مصطفوي,Mostafawi Mosque,1,0,800,862,1663
1,10110,101208,مکتب متوسطه چهارقلعه وزير آباد,Chahar Qalla e Wazir Abad Secondary School,0,5,533,555,1093
1,10110,101209,مسجد يادگار,Yadgar Mosque,1,6,1087,1914,3008
1,10110,101210,مسجد عمرفاروق,Omer Farooq Mosque,0,2,398,649,1049
1,10110,101211,مسجد احمد خيل,Ahmad Khil Mosque,0,0,1084,1790,2874
1,10110,101212,مسجد محمديه,Mohammadia Mosque,0,0,981,1079,2060
1,10110,101213,مسجد امام ابو حنيفه,Imam Abu Haneefa Mosque,0,12,1010,2382,3404
1,10110,101214,مسجد ئ ئ رقیه,Bibi Ruqia Mosque,0,28,867,1350,2245
1,10110,101215,مسجد جامع الجواد,Aljawad Jame Mosque,0,1,1455,1827,3283
1,10110,101216,پسته خانه مقابل کلینیک,Post office infront of the clinic,1,2,115,777,895
1,10110,101217,مسجد ابراهيم خليل الله,Ibrahim Khalilullah Mosque,0,0,345,710,1055
1,10110,101218,مسجد شک چهار,Sarak e Chahar Mosque,1,6,381,1528,1916
1,10110,101219,مسجد حسينيه,Hussainia Mosque,0,1,240,532,773
1,10110,101220,مکتب متوسطه مسعود سعد,Masoud Sa'ad Secondary School,1,0,844,1094,1939
1,10110,101221,مسجد فاطميه,Fatimia Mosque,0,7,430,704,1141
1,10110,101222,ليسه نسوان زرغونه,Zarghoona Girls High School,0,5,1872,1996,3873
1,10110,101223,ليسه احمد شاه مسعود,Ahmad Shah Masoud High School,2,1,171,1107,1281
1,10110,101554,مکتب شهرک آریا,Shahrak Arya School,1,1,583,1461,2046
1,10111,101224,مکتب متوسطه نمت ١٦,Secondary School no. 16,0,3,429,824,1256
1,10111,101225,لیسه ذکور سیدالناصری,Sayedul Naseri Boys High School,3,2,824,2771,3600
1,10111,101226,لیسه نسوان سیدالناصری,Sayedul Naseri Girls High School,2,4,1324,1840,3170
1,10111,101227,سینما ختخانه,Khairkhana Cinema,3,1,535,1909,2448
1,10111,101228,لیسه مخق بدخش,Makhfi Badakhshi High School,0,1,2019,1751,3771
1,10111,101229,ليسه غلام حيدر خان,Ghulam Haider Khan High School,1,1,1248,4539,5789
1,10111,101230,لیسه عبدالغفور ندیم,Abdul Ghafour Nadeem High School,0,0,1176,2074,3250
1,10111,101231,مسجد جامع امام زمان,Imam Zaman Jame Mosque,0,3,519,1643,2165
1,10111,101232,لیسه ذلیخا,Zulaikha High School,0,0,1990,1843,3833
1,10111,101233,مسجد پنجصد فاميل,Punj Sad Family Mosque,0,2,787,2391,3180
1,10111,101234,لیسه عبدالقادر بیدل,Abdul Qader Bedel High School,0,3,3158,4243,7404
1,10111,101235,مسجد اصحاب کهف,Ashab e Kahaf Mosque,0,0,760,1714,2474
1,10111,101236,مسجد بابا آدم صق الله,Baba Adam Safiullah Mosque,2,0,812,1106,1920
1,10111,101237,مسجد پنج پتان,Punj Peeran Mosque,1,1,654,2552,3208
1,10111,101238,مکتب متوسطه سادات,Sadaat Secondary School,0,0,473,1078,1551
1,10111,101239,لیسه پروژه,Purojha High School,2,0,1984,3128,5114
1,10111,101240,مکتب متوسطه هزاره بغل,Hazarah Baghal Secondary School,1,1,418,1500,1920
1,10111,101241,مسجد قبا,Quba Mosque,1,3,927,2592,3523
1,10111,101242,مسجد ابو هریره,Abu Huraira Mosque,0,0,532,1093,1625
1,10111,101243,ليسه خليل الله خليل,Khalilullah Khalili High School,0,29,970,1850,2849
1,10111,101244,فاتحه خانه زنانه,Fateha Khana e Zanana,1,2,1159,2728,3890
1,10111,101245,مکتب متوسطه ئ ئ حوا,Bibi Hawa Secondary School,0,1,844,1622,2467
1,10111,101246,مسجد انس بن مالک,Anas Bin e Malik Mosque,0,17,386,1376,1779
1,10111,101247,ليسه آزاد خان,Azad Khan High School,0,0,537,2975,3512
1,10111,101248,لسیه ئ ئ شوری سنگری,Bibi Sarwari Sangari High School,0,2,1998,2946,4946
1,10112,101249,لیسه عالی محمد موش شفیق,Mohammad Musa Shafiq High School,0,140,1734,5220,7094
1,10112,101250,لیسه عالی عبدالروف بینوا,Abdul Raouf Benawa High School,2,135,1124,4006,5267
1,10112,101251,لیسه صدیق الله رشتی,Sidiqullah Reshteen High School,0,273,1528,4978,6779
1,10112,101252,لیسه عبدالقیوم وردک,Abdul Qayoum Wardak High School,2,153,1111,5723,6989
1,10112,101253,لیسه غلام صدیق,Ghulam Sediq High School,4,157,1655,5867,7683
1,10112,101254,مکتب متوسطه استاد ابراهیم خواخوږی,Ustad Ibrahim Khwakhogai Secondary School,2,52,1255,3018,4327
1,10112,101255,مکتب متوسطه قلعه جبارخان,Qalla e Jabar Khan Secondary School,0,215,1106,3164,4485
1,10112,101256,لیسه نسوان محمد اکت خان پامت,Mohammad Akbar Khan Pamir Girls High School,1,29,1740,5095,6865
1,10112,101257,لیسه غلام محمد فرهاد,Ghulam Mohammad Farhad High School,2,65,1435,5812,7314
1,10112,101258,لیسه نسوان احمد شاه بابا,Ahmad Shah Baba Girls High School,0,82,1328,2861,4271
1,10112,101259,لیسه قیام الدین خادم,Qeyamuddin Khadim High School,2,49,2300,6438,8789
1,10112,101260,لیسه ئ ئ عایشه صدیقه,Bibi Aayesha Sediqa High School,1,105,1918,3418,5442
1,10112,101261,ليسه حضت ابراهيم خليل الله,Hazrat Ibrahim Khalilullah High School,4,53,1672,7263,8992
1,10112,101262,متوسطه نوآباد (زن آباد),Nawabad (Zan Abad) Secondary School,1,68,715,1508,2292
1,10112,101555,مسجد جامع امام ابوحنیفه,Emam Abo Hanifa Mosque,0,37,845,1746,2628
1,10112,101556,مسجد سفید,Safid Mosque,3,616,2217,2527,5363
1,10113,101263,لیسه شهرک مهدیه,Shahrak Mahdia High School,1,10,4121,3793,7925
1,10113,101264,مسجد محمدیه,Mohammadia Mosque,0,1,2242,2886,5129
1,10113,101265,مسجد امام مهدی,Imam Mahdi Mosque,0,2,1178,1220,2400
1,10113,101266,مسجد باقرالعلوم,Baqerul Uloom Mosque,0,3,1623,1831,3457
1,10113,101267,لیسه نسوان زینب کتا,Zainab Kubra Girls High School,0,0,2026,933,2959
1,10113,101268,مسجد متسیدعل یخ سوز,Mir Sayed Ali Yakhsoz Mosque,0,1,1451,1585,3037
1,10113,101269,مسجد حسينيه,Husainia Mosque,1,0,856,750,1607
1,10113,101270,لیسه شهرک,Shahrak High School,0,0,0,272,272
1,10113,101271,مسجد سجادي,Sejadi Mosque,1,0,685,863,1549
1,10113,101272,مسجد سنائ,Sanayee Mosque,0,5,1760,1613,3378
1,10113,101273,مسجد مهدويه,Mahdawya Mosque,0,0,1631,1057,2688
1,10113,101275,مسجد قران و عتت,Quran wa Itrat Mosque,1,0,2013,2930,4944
1,10113,101276,مسجد امام خمین,Imam Khumaini Mosque,0,1,2323,2810,5134
1,10113,101277,مسجد اتحاد,Itehad Mosque,0,1,1157,2297,3455
1,10113,101278,مسجد امتالمومنی,Amirul Momineen Mosque,2,0,1262,2168,3432
1,10113,101279,ليسه عبد الرحيم شهيد,Abdul Rahim Shaheed High School,0,0,1357,1988,3345
1,10113,101280,مسجد امام زمان,Imam Zaman Mosque,0,0,1590,1838,3428
1,10113,101281,لیسه نو آباد دوغ آباد,Nawabad Doghabad High School,0,0,307,306,613
1,10113,101282,مسجد حنيق,Hanifi Mosque,0,0,953,1081,2034
1,10113,101283,مسجد اتفاق,Itefaq Mosque,1,0,2342,5047,7390
1,10113,101284,لیسه ذکور شهرک صفا,Shahrak e Safa Boys High School,0,1,1844,1452,3297
1,10113,101285,مسجد بابل حوایج,Babul Hawaej Mosque,0,1,1393,1588,2982
1,10113,101286,مسجد قهرمان کربلا,Qahraman e Karbala Mosque,0,1,1337,1539,2877
1,10113,101287,مسجد بقيت الله,Baqeetullah Mosque,1,1,3264,4148,7414
1,10113,101288,مسجد امام محمد تق,Imam Mohammad Taqi Mosque,0,0,0,786,786
1,10113,101289,ليسه معرفت,Marefat High School,0,0,1159,3720,4879
1,10113,101290,مسجد مالک اشت,Malik e Ushtur Mosque,0,1,2286,2872,5159
1,10113,101291,مسجد قمر بن هاشم,Qamar Bani Hashim Mosque,1,3,3022,3833,6859
1,10113,101292,لیسه سیدالشهدا,Sayed ul Shuhada High School,1,5,2125,2218,4349
1,10113,101293,مسجد امام هادی,Imam Hadi Mosque,0,1,3491,4053,7545
1,10113,101294,مکتب متوسطه شهرک محمدیه,Shahrak Mohammadia Secondary School,0,8,2322,2905,5235
1,10113,101295,ليسه همايون شهيد,Humayoon Shaheed High School,1,2,3089,2885,5977
1,10113,101296,لیسه قاض,Qazi High School,0,47,993,1743,2783
1,10113,101297,مسجد قمت بن هاشم,Qambar Bin e Hashim Mosque,0,2,572,917,1491
1,10114,101300,مسجد آغا صاحب,Agha Saheb Mosque,0,6,1242,4616,5864
1,10114,101301,مکتب متوسطه سیدکریم,Sayed Karim Secondary School,0,13,643,1432,2088
1,10115,101085,مسجد شاه اوليا,Shah e Awlya Mosque,0,1,508,1126,1635
1,10115,101302,ليسه عبدالاحمد جاوید,Abdul Ahmad Jawed High School,1,764,1667,3060,5492
1,10115,101303,مسجد حضت حمزه,Hazrat Hamza Mosque,0,431,873,1766,3070
1,10115,101304,لیسه شیخ زاهد,Shiekh Zahid High School,1,12,608,2127,2748
1,10115,101305,مسجد اقصی,Aqsa Mosque,1,10,1019,2666,3696
1,10115,101306,مسجد پروژه خراسان,Purozha e Khurasan Mosque,0,0,477,1080,1557
1,10115,101308,مسجدم جامع ام زفر,Umme Zafar Jame Mosque,2,1,581,821,1405
1,10115,101309,مسجد شهدا پنجصد فاميل,Punj Sad Family Shuhada Mosque,2,1,453,1250,1706
1,10115,101310,لیسه محمد انور بسمل,Mohammad Anwar Bismil High School,0,0,1989,2620,4609
1,10115,101311,مدرسه تعلیم القران ئ ئ فاطمه زهرا,Bibi Fatimatul Zahra Taleemul Quran Madrassah,1,0,1378,2228,3607
1,10115,101312,مسجد حضت يوسف,Hazrat Yousuf Mosque,0,0,184,392,576
1,10115,101313,مسجد حضت نوح,Hazrat Nouh Mosque,0,8,467,1687,2162
1,10115,101314,لیسه محمد فقت فتوزی,Mohammad Faqir Ferozi High School,0,2,1031,1677,2710
1,10115,101315,لیسه ئ ئ ساره,Bibi Sarah High School,1,4,2081,2314,4400
1,10115,101316,مسجد شور کاينات,Sarwar e Kainat Mosque,6,12,545,2300,2863
1,10115,101317,مسجد حضت خدر,Hazrat Khedar Mosque,1,4,711,1556,2272
1,10115,101318,مسجد سعد ابن وقاض,Sa'ad Ibne Waqas Mosque,0,7,506,856,1369
1,10115,101319,مسجد حضت ختالبسر,Hazrat Khairul Bashar Mosque,0,5,544,2146,2695
1,10115,101320,رياست اطفايه,Reyasat Itfaya (Firefighting Directorate),0,1,377,1395,1773
1,10115,101321,متوسطه نمت ۲ خواجه بغرا,Khwaja Bughra Secondary School No.2,1,0,636,1049,1686
1,10115,101322,مسجد جامع خاتم الانبیاء,Khatimul Anbya Jame Mosque,0,0,679,1321,2000
1,10115,101323,مسجد خواجه محی الدين چشن,Khwaja Mohiuddin Chushti Mosque,0,0,386,584,970
1,10115,101324,مسجد زيد بن ثابت,Zaid Bin Sabit Mosque,0,0,565,826,1391
1,10115,101325,مسجد جامع خواجه بغرا,Khwaja Bughra Jame Mosque,0,3,424,1182,1609
1,10115,101326,مسجد قطيبيه,Qutaibia Mosque,2,17,726,2987,3732
1,10115,101327,مسجد محمد حنیفه غازی,Mohammad Haneefa Ghazi Mosque,0,1,754,1811,2566
1,10115,101328,مسجد حضت عمر فاروق,Hazrat Omer Farouq Mosque,1,1,577,1028,1607
1,10115,101329,پرورشگاه فرشته نجات,Parwareshgah (Orphanage)Fareshtah e Nejat,0,0,304,491,795
1,10115,101330,مسجد آل محمد,Aal e Mohammad Mosque,0,0,450,661,1111
1,10115,101331,مسجد امام طهاوی,Imam Tahawi Mosque,1,3,1315,2767,4086
1,10116,101332,مکتب متوسطه شهیدان,Shaheedan Secondary School,0,21,960,659,1640
1,10116,101333,مسجد عثمان غن,Usman Ghani Mosque,0,4,0,791,795
1,10116,101334,لیسه نسوان ده خدایداد,Deh Khudidad Girls High School,0,5,976,910,1891
1,10116,101335,ليسه شهرک خراسان,Shahrak e Khurasan High School,0,335,2326,5007,7668
1,10116,101336,لیسه ذکور قلعه احمدخان,Qalla e Ahmad Khan Boys High School,0,13,1138,3154,4305
1,10116,101337,مکتب متوسطه آلوخیل,Alokhil Secondary School,1,78,1267,3965,5311
1,10116,101338,لیسه غفوراحمدی,Ghafoor Ahmadi High School,0,67,497,2247,2811
1,10116,101340,مسجد ابو ايوب انصاري,Abu Ayub Ansari Mosque,0,1,147,514,662
1,10116,101341,مسجد حضت بلال,Hazrat Bilal Mosque,0,26,1365,2712,4103
1,10116,101342,مسجد ابو عبيده,Abu Obaidah Mosque,0,27,585,1918,2530
1,10116,101343,مکتب متوسطه قلعه زمان خان,Qalla e Zaman Khan Secondary School,0,18,967,1995,2980
1,10116,101344,مکتب متوسطه نازو انا,Nazo Ana Secondary School,0,7,304,939,1250
1,10116,101345,لیسه لامعه شهید,Lamia Shaheed High School,1,20,2151,2597,4769
1,10116,101346,تعمت ناحیه شانزدهم,Nahia no. 16 Building,0,8,403,1786,2197
1,10117,101347,مکتب ابتدائیه جدیدالتاسیس نو آباد,Nawabad Newly established Primary School,0,24,490,2027,2541
1,10117,101348,لیسه قاری نیک محمد,Qari Nek Mohammad High School,0,13,2006,3503,5522
1,10117,101349,لیسه آزادی,Azadi High School,1,2,1474,3632,5109
1,10117,101350,لیسه شهرک ذاکرین,Shahrak Zakereen High School,2,105,2040,3829,5976
1,10117,101351,مرکز ناحيه ١٧,Markaz Nahia 17 (Nahia 17 Center),1,17,2427,6117,8562
1,10117,101352,لیسه نسوان پامت,Pamir Girls High School,2,9,2091,4445,6547
1,10117,101353,لیسه شهرک طلائ,Shahrak e Telayee High School,1,25,1561,4243,5830
1,10117,101354,مسجد جامع ابوبکر صدیق,AbuBakar Sedique Jame Mosque,0,23,498,1739,2260
1,10117,101355,لیسه نسوان شهرک وحدت,Shahrak Wahdat Girls High School,0,28,1843,3855,5726
1,10117,101356,لیسه برهان الدین ربائ,Burhanuddin Rabani High School,0,62,1118,2135,3315
1,10117,101357,مسجدجامع حضت عل,Hazrat Ali Jame Mosque,0,1,1075,2694,3770
1,10118,101358,مسجد وزیر ګل,Wazeer Gul Mosque,0,318,135,2210,2663
1,10118,101359,ابتدایه نواباد,Nawabad Primary School,0,7,381,1645,2033
1,10118,101360,لیسه محمدجان خان,Mohammad Jan Khan High School,2,73,668,3052,3795
1,10118,101361,لیسه شهرک محمدیه,Shahrak Mohamadia High School,2,24,1045,3413,4484
1,10119,101362,لیسه صلح,Sulh High School,1,63,1226,3310,4600
1,10119,101363,ليسه پل چرچ,Pul e Charkhi High School,0,114,1933,5765,7812
1,10121,101364,حاچ زعفران منحن شوونحی,Haji Zafran Secondary School,0,2370,321,653,3344
1,10121,101365,مسجد حاچ شدار,Haji Sardar Mosque,1,2173,622,1508,4304
1,10121,101366,مسجد شیف قول باهو,Sahreef Qul Baho Mosque,1,4555,108,1104,5768
1,10121,101367,مسجد حمزه,Hamza Mosque,0,3761,206,1053,5020
1,10121,101368,مکتب متوسطه سپی غر,Speen Ghar Secondary School,3,4483,328,1277,6091
1,10121,101369,مسجد شیف گل سعید خان,Shareef Gul Sayeed Khan Mosque,2,4244,70,975,5291
1,10121,101370,شفاخانه 75 بست,75 Beds Hospital,2,3522,491,3449,7464
1,10121,101371,مسجد احمد جان,Ahmad Jan Mosque,3,4344,611,2596,7554
1,10121,101372,مدرسه دین کوچیان,Kochian Religious Madrassah,2,4676,498,3150,8326
1,10121,101373,مسجد حاچ ستار خان شامحمد خیل,Haji Satar Khan Shah Mohammad Khil Mosque,0,126,231,454,811
1,10121,101374,ابتدائیه نمت اول جنت گل,Janat Gul Primary School No. 1,1,358,852,1096,2307
1,10121,101375,مکتب حاچ سناتور جنت ګل,Senator Haji Janat Gul School,6,5015,115,3087,8223
1,10122,101559,دفت ناحیه,Nahia Office,5,352,2785,3825,6967
1,10101,101001,مسجد ش گردنه,Sar e Gardana Mosque,1,0,97,335,433
1,10101,101002,مسجد درخت شنگ,Derakht e Shing Mosque,0,1,231,571,803
1,10101,101003,مسجد ملا محمود,Mullah Mahmood Mosque,121,5,535,1565,2226
1,10101,101004,مکتب متوسطه دقیق بلحی,Daqiqi Balkhi Secondary School,0,3,321,927,1251
1,10101,101005,مسجد آخر جاده,Aakhir e Jada Mosque,0,5,0,706,711
1,10101,101006,مسجد عيد گاه,Eidgah Mosque,0,6,278,716,1000
1,10101,101007,مکتب عنضی بلحی,Ansuri Balkhi School,1,8,165,1011,1185
1,10101,101008,ليسه عايشه درائ,Aayesha Durani High School,1,6,288,1542,1837
1,10101,101009,مکتب متوسطه مستوری غوری,Mastoori Ghoori Secondary School,1,2,178,1174,1355
1,10101,101010,ليسه عاشقان و عارفان,Aasheqan wa Arefan High School,0,0,71,505,576
1,10101,101011,مکتب متوسطه عاشقان و عارفان,Aasheqan wa Arefan Secondary School,0,0,554,1175,1729
1,10101,101012,مسجد ش کاریز,Sar e Karez Mosque,0,0,205,503,708
1,10101,101013,مسجد بالا قلعه,Bala Qilla Mosque,0,0,227,830,1057
1,10101,101014,لیسه محجوبه,Mahjooba High School,1,6,288,487,782
1,10101,101015,تکیه خانه جعفریه,Takya Khanahh Jafarya,0,2,906,2282,3190
1,10101,101016,مسجد امام باقر,Imam Baqer Mosque,0,0,622,1025,1647
2,201,201001,لیسه ذکور,Boys High School,0,3,59,806,868
2,201,201002,مسجد جامع زراعت,Zara'at Jame Mosque,0,2942,169,410,3521
2,201,201003,لیسه الله محمد شوج (کوج),Allah Mohammad Shokhi (Kochi) High School,0,648,313,924,1885
2,201,201004,مسجد جامع زکوزات,Zakozai Mosque,0,2468,168,235,2871
2,201,201005,مسجدمرحوم سید میجان,Late Sayed Mir Jan Mosque,0,657,298,624,1579
2,201,201006,لیسه خال محمد,Khal Mohammad High School,0,388,176,1311,1875
2,201,201007,نسوان ریگروان,Regrawan Girls School,0,129,283,581,993
2,201,201008,لیسه نسوان,Girls High School,0,2738,368,618,3724
2,201,201009,مسجد قلعه سفید,Qalla e Safid Mosque,0,2,245,1104,1351
2,201,201010,مکتب نسوان علی خیل,Ali Khil Girls School,0,40,325,1077,1442
2,201,201011,لیسه نسوان قاری میعثمان شهید,Qari Mir Usman Shaheed Girls High School,0,5,418,1014,1437
2,201,201012,لیسه حضت مصعب,Hazrat Masab High School,0,1,260,944,1205
2,201,201013,لیسه نسوان قاض خیل,Qazi Khil Girls High School,0,0,592,1347,1939
2,201,201014,لیسه ذکور محمود راق,Mahmoud Raqi Boys High School,0,10,1038,1750,2798
2,201,201015,لیسه نسوان محمود راق,Mahmoud Raqi Girls High School,0,66,505,372,943
2,201,201016,مسجد ملک ج خیل,Malik Gee Khil Mosque,0,4,579,785,1368
2,202,202017,مکتب متوسطه نسوان الحاج غلام سخ,Alhaj Ghulam Sakhi Girls Secondary School,0,1,686,1156,1843
2,202,202018,مکتب متوسطه حاج محمد حکیم شهی,Haji Mohammad Hakim Shaheed Secondary School,0,1,562,995,1558
2,202,202019,مکتب ابتدائیه جلال الدین شهید,Jalaluddin Shaheed Primary School,0,40,1234,2168,3442
2,202,202020,لیسه ذکور محمد انور شهید,Mohammad Anwar Shaheed Primary School,0,0,706,1119,1825
2,202,202021,مکتب ابتدائیه فیض محمد شهید,Faiz Mohammad Shaheed Primary School,0,0,1001,1870,2871
2,202,202022,مسجد خم روباه,Kham Robah Mosque,0,0,506,1623,2129
2,202,202023,مکتب ابتدائیه عنایت الله,Enayatullah Primary School,0,61,1608,2822,4491
2,202,202024,مکتب محمدطاهر شهید,Mohammad Tahir Shaheed School,0,231,689,1948,2868
2,202,202094,مکتب ملامحمد شهید,Mullah Muhammad Shahid School,0,413,490,923,1826
2,203,203025,مسحد پل میویس,Pul e Mirwais Mosque,0,118,1836,1754,3708
2,203,203026,مکتب ابتدایه نسوان قلعه عطلخان,Qalla e Atta Khan Girls Primary School,0,0,494,1165,1659
2,203,203027,مسجد جامع سرجوی نهر خواجه,"Nahr e Khwaja, Sar e Joi Jame Mosque",0,87,1005,2177,3269
2,203,203028,مسجد حبیب خیل,Habib Khil Mosque,0,33,1684,2226,3943
2,203,203029,مسجد لعل بیک خیل,Lal Baig Khil Mosque,0,3,1945,2494,4442
2,203,203030,لیسه اناث بولغی,Bolgheen Girls High School,0,114,528,1550,2192
2,203,203031,لیسه عبدالباق شهید,Abdul Baqi Shaheed High School,0,0,334,603,937
2,203,203032,مسجد محمد عمر خیل,Mohammad Omerkhil Mosque,0,0,177,371,548
2,204,204033,مکتب ابتدائیه سنجن,Sanjan Primary School,0,68,428,1614,2110
2,204,204034,مکتب الحاقیه قلعه می,Ilhaqya Qalla e Mir School,0,142,599,1538,2279
2,204,204035,مکتب متوسطه عبدالشکورخان,Abdul Shukoor Khan Secondary School,0,10,620,1115,1745
2,204,204036,لیسه نسوان نمازجای,Namaz Jai Girls High School,0,3,820,1337,2160
2,204,204037,مدرسه حقانیه شیخان خیل,Haqania Sher Khan Khil Madrassah,0,0,609,1142,1751
2,204,204038,لیسه نسوان نساج گلبهار,Nasaji Gulbahar Girls High School,0,2,694,1585,2281
2,204,204039,مکتب متوسطه ناصرخانخیل,Naser Khan Khil Secondary School,0,2,755,1910,2667
2,204,204040,مکتب متوسطه جلدک,Jaldak Secondary School,0,4,345,841,1190
2,204,204041,لیسه نسوان اشیگرام,Ushtergram Girls High School,0,36,949,1036,2021
2,204,204042,لیسه میمسجدی خان,Mir Masjidi Khan High School,0,1,963,1638,2602
2,204,204043,لیسه ایزدیار شهید,Izadyar Shaheed High School,0,1,411,919,1331
2,204,204044,مسجد ملاخلیل,Mula Khalil Mosque,0,19,391,971,1381
2,204,204045,لیسه محمد عمر شهید,Mohammad Omer Shaheed High School,0,235,674,1517,2426
2,204,204046,مکتب متوسطه حقبی شهید,Haqbeen Shaheed Secondary School,0,17,940,1599,2556
2,205,205047,مکتب گیاوه,Gyawah School,0,286,1680,1498,3464
2,205,205048,مکتب متوسطه کهلوت,Kahloot Secondary School,0,1,290,349,640
2,205,205049,مکتب نسوان زرشوی,Zarshoi Girls School,0,8,190,489,687
2,205,205050,مکتب نسوان قلعه غن,Qalla e Ghani Girls School,0,2,774,1096,1872
2,205,205052,مکتب نسوان بدخش,Badakhshi Girls School,0,3,462,624,1089
2,205,205053,مکتب متوسطه روزاخیل,Rozakhil Secondary School,0,0,330,540,870
2,205,205054,متوسطه نسوان دره فرخشاه,Darah e Farukh Shah Secondary School,0,45,893,1637,2575
2,205,205055,مکتب میزا عبدالرحمن شهید,Mirza Abdul Rahman Shaheed School,0,5,639,983,1627
2,205,205056,مکتب ابراهیم خیل,Ibrahim Khil School,0,0,533,742,1275
2,205,205057,ساحه آزاد,Saha e Azad (Open ground),0,6,578,1242,1826
2,205,205058,مکتب څارنوال حبیب الرحمن شهید,Saranwal Habibul Rahman Shaheed School,0,0,557,814,1371
2,205,205059,لیسه ضیاالحق شهید,Ziaulhaq Shaheed High School,0,0,325,634,959
2,205,205060,مسجد سابات,Sabat Mosque,0,126,128,540,794
2,205,205061,مکتب غلام جیلات شهید,Ghulam Jailani Shaheed School,0,0,516,985,1501
2,205,205062,مسجد باغ امان,Bagh e Aman Mosque,0,0,614,1072,1686
2,205,205063,لیسه ذکور تاجکان,Tajikan Boys High School,0,8,933,1106,2047
2,205,205064,لیسه عبدالغفار شهید,Abdul Ghafar Shaheed High School,0,0,872,1518,2390
2,205,205065,مسجد ویشار,Weeshar Mosque,0,3,327,660,990
2,205,205066,مکتب یاسی زات,Yaseenzai School,0,1,637,868,1506
2,205,205067,مکتب قاض عبدالجمیل,Qazi Abdul Jamil School,0,57,7,613,677
2,205,205051,مسجد جامع ولسوالی,Woleswali (District)Jame Mosque,0,5,554,2135,2694
2,206,206070,متوسطه شهید سلیم,Shaheed Salim Secondary School,0,1,12,1070,1083
2,206,206071,مسجد حده انور,Hudah e Anwar Mosque,0,2,26,1203,1231
2,206,206072,مسجد جالو خیل,Jalo Khil Mosque,0,102,71,2188,2361
2,206,206073,مسجد مقام خیل,Moqam Khil Mosque,0,0,56,1681,1737
2,206,206076,متوسطه شهید حفیظ الله,Shaheed Hafeezullah Secondary School,0,91,183,2177,2451
2,206,206077,لیسه غازی عثمان,Ghazi Usman High School,0,1,274,2964,3239
2,206,206084,مسجد شلوات,Shalwati Mosque,0,65,501,1644,2210
2,206,206085,مکتب پاینده خیل,Payenda Khil School,0,41,423,2134,2598
2,206,206086,متو سطه آغاشین,Agha Shereen Secondary School,0,246,297,1573,2116
2,207,207087,مسجد سلطانخیل,Sultan Khil Mosque,0,10,0,1085,1095
2,207,207088,لیسه حیات الله شهید,Hayatullah Shaheed High School,0,27,0,976,1003
2,207,207089,مکتب ابتدائیه حسن شهید,Hassan Shaheed Primary School,0,22,0,1104,1126
3,301,301001,لیسه لیلا صراحت روشن,Laila Sarahat Roshani High School,0,3,551,746,1300
3,301,301002,لیسه حره جلالی,Hurrah e Jalali High School,0,1,1158,3043,4202
3,301,301003,لیسه صادق (( رح )),Sadeqi High School,0,1,1462,2468,3931
3,301,301004,مسجد جامع ن ن صفیه,Bibi Safia Jame Mosque,0,2,573,1277,1852
3,301,301005,مسجد جامع عمر فاروق,Omer Farouq Jame Mosque,0,1,152,310,463
3,301,301006,مکتب پارچه ۱۳ شهری,Parcha 13 Shahri School,0,2,338,902,1242
3,301,301007,لیسه می علی احمد شهید,Mir Ali Ahmad Shaheed High School,0,43,1277,1494,2814
3,301,301008,لیسه می عبدالکریم (( معقول )),Mir Abdul Karim Maqoul High School,0,0,702,880,1582
3,301,301009,لیسه عالی تجربوی محمد عثمان,Mohammad Usman Experimental High School,0,2,883,3258,4143
3,301,301010,مسجد جامع صادق پادشاه (( رح )),Sadeqi Padshah Jame Mosque,0,0,481,1605,2086
3,301,301011,لیسه نعمان,Noman High School,0,1,175,919,1095
3,301,301012,مسجد جامع بالاغیل,Bala Ghel Jame Mosque,0,0,222,884,1106
3,301,301013,مسجد حاچ عبدالقدوس,Abdul Qudous Jame Mosque,0,0,0,279,279
3,301,301014,لیسه میانشاخ,Myan Shahkh High School,0,0,255,843,1098
3,301,301015,مکتب نسوان پشیان,Pashayan Girls School,0,0,76,461,537
3,301,301016,مکتب متوسطه قلعچه سوخته,Qalacha e Sokhta Secondary School,0,0,276,662,938
3,301,301017,مکتب متوسه بایان پائی,Bayan Payen Secondary School,0,2,181,462,645
3,301,301018,لیسه دولانه,Dolana High School,0,1,316,582,899
3,301,301019,مدرسه الحاقیه خدیجه الکیا,Ilhaqya Khadijatul Kubra Madrassah,0,14,190,482,686
3,301,301020,مکتب متوسطه بایان بالا,Bayan Bala Secondary School,0,1,370,908,1279
3,301,301021,لیسه امان الله شهید,Amanullah Shaheed High School,0,23,495,1480,1998
3,301,301022,لیسه ده قاض,Deh Qazi High School,0,7,199,617,823
3,301,301023,مکتب صیادان,Sayadan School,0,0,510,946,1456
3,301,301024,لیسه ذکور توغبیدی,Toghbeerdee Boys High School,0,0,252,824,1076
3,301,301025,مکتب نسوان تیلا نچ,Telanchi Girls School,0,1,184,405,590
3,301,301026,لیسه دادو,Dadu High School,0,3,342,1134,1479
3,301,301027,لیسه عمر فاروق,Omer Farouq High School,0,0,598,936,1534
3,301,301028,لیسه تتمدره علیا,Tatumdarah e Ulya High School,0,0,739,1651,2390
3,301,301029,مکتب متوسطه هوفیان سریف,Hofyan e Shareef Secondary School,0,0,540,1140,1680
3,301,301030,مکتب متوسطه خواجه سیاران علیا,Khwaja Sayaran Ulya Secondary School,0,0,82,422,504
3,301,301031,دارالعلوم شهید مولوی عبدالرحیم حنف,Shaheed Mawlawi Abdul Rahim Hanafi Darul Uloom,0,0,478,1139,1617
3,301,301032,مکتب خواجه سیاران پایان,Khwaja Sayaran Payan School,0,1,919,1543,2463
3,301,301033,لیسه لغمان,Laghmani High School,0,10,429,1329,1768
3,301,301034,مکتب توب دره,Tob Darah School,0,1,141,536,678
3,301,301035,لیسه مسعود بزرگ,Masoud Buzurg High School,0,0,196,274,470
3,301,301036,لیسه ملا حکم شهید,Mullah Hakam Shaheed High School,0,0,72,1013,1085
3,302,302037,مکتب قلعه نصرو,Qalla e Nasro School,0,22,442,1342,1806
3,302,302038,مسجد باریک آب,Bareek Aab Mosque,0,29,300,337,666
3,302,302039,لیسه شهرک مهاجرین بارک آب,Shahrak Mohajereen Bareek Aab High School,0,2,253,533,788
3,302,302040,مدرسه نکاح خیل,Nikah Khil Madrassah,0,12,348,1157,1517
3,302,302041,مکتب متوسطه نسوان خانقا,Khanqa Girls Secondary School,0,48,1055,1799,2902
3,302,302042,لیسه ناصری,Naseri High School,0,619,1132,1823,3574
3,302,302043,لیسه قلعه بلند,Qalla Band High School,0,25,1320,1152,2497
3,302,302044,مکتب طالوت شهید,Taloot Shaheed School,0,6,1049,1667,2722
3,302,302045,مکتب شیآقا شهید,Sher Aqa Shaheed School,0,13,559,3604,4176
3,302,302046,مکتب جانقدم,Janqadam School,0,0,644,820,1464
3,302,302047,لیسه نسوان میدان هوای بگرام,Bagram Airport Girls High School,0,14,648,1575,2237
3,302,302048,مسجد جامع دهن میدان,Dahan Maidan Jame Mosque,0,85,1132,2158,3375
3,302,302050,لیسه شفق شهید,Shafaq Shaheed High School,0,0,646,1683,2329
3,302,302051,مکتب ملا محمد شهید و مسجد تونچ,Mullah Mohammad Shaheed School and Tonchi Mosque,0,3,438,1036,1477
3,302,302052,مسجد جامع یورچ,Yorchi Jame Mosque,0,0,295,935,1230
3,302,302053,لیسه قلعه ملک,Qalla e Malik High School,0,0,445,586,1031
3,302,302054,لیسه عبدالستار شهید,Abdul Sattar Shaheed High School,0,1,712,1561,2274
3,302,302055,مسجد ده ملا,Deh Mullah Mosque,0,0,299,775,1074
3,302,302056,مکتب عزیز رحما ن شاه,Aziz Rahman Shah School,0,1,95,2200,2296
3,302,302057,مسجد جامع ده مسکی,Deh Meskeen Jame Mosque,0,2,486,916,1404
3,302,302058,مکتب متوسط قاض عبدالجمیل خیل,Qazi Abdul Jamil Khil Secondary School,0,0,549,807,1356
3,302,302059,لیسه ابوذر غفاری,Abu Zar Ghafari High School,0,1,1367,3389,4757
3,302,302060,نسوان قلعه دشت رباط,Qalla e Dasht Rubat Girls School,0,2,392,1304,1698
3,302,302049,مکتب متوسطه نسوان غلام علی,Ghulam Ali Girls Secondary School,0,0,888,1002,1890
3,303,303062,لیسه عبدالستار شهید,Abdul Satar Shaheed High School,0,4,714,1512,2230
3,303,303066,مکتب متوسطه صوق خیل,Sofi Khil Secondary School,0,3,232,1658,1893
3,303,303067,مکتب تفهیم القران,Tafheem ul Quran School,0,1,791,2786,3578
3,303,303068,مکتب جان فدا شهید,Jan Fida Shaheed School,0,0,178,335,513
3,303,303069,مدرسه مولوی یارمحمد,Mawlawi Yar Mohammad Madrassah,0,2,916,3851,4769
3,303,303070,مکتب دراز گرد,Daraz Gerd School,0,0,0,268,268
3,303,303172,مکتب متوسطه نمک آب,Namakab Secondary School,0,2,673,858,1533
3,304,304071,مسجد انچو,Ancho Mosque,0,0,848,893,1741
3,304,304072,مکتب لیسه ابوحنیفه انچو,Abu Hanifah Ancho High School,0,0,521,809,1330
3,304,304073,مسجد سه دوکان انچو,Sehdukan Anchu Mosque,0,1,458,547,1006
3,304,304074,لیسه امام اعظم آقتاش,Imam Azam Aaqtash High School,0,0,192,380,572
3,304,304075,لیسه نسوان قاض خیل,Qazi Khil Girls High School,0,34,542,1099,1675
3,304,304076,لیسه نسوان سیدخیل,Sayed Khil Girls High School,0,1,862,1134,1997
3,304,304077,لیسه نسوان هیبت خیل,Haibat Khil Girls High School,0,0,908,1035,1943
3,304,304078,مکتب لیسه گل آقا شهید,Gul Aqa Shaheed High School,0,0,151,348,499
3,304,304079,مسجد و الحاقیه چینکی پایان,Chainaki Payan Mosque and Ilhaqya,0,0,164,397,561
3,304,304080,متوسطه عبدالقادر شهید,Abdul Qader Shaheed Secondary School,0,1,237,508,746
3,304,304081,لیسه نسوان چینکی علیا,Chainaki Ulya Girls High School,0,1,321,457,779
3,304,304082,لیسه سیف الرحمن شهید,Saiful Rahman Shaheed High School,0,0,0,190,190
3,304,304083,کلینیک معازالدین خیل,Ma'azuddin Khil Clinic,0,0,237,506,743
3,304,304084,دارالحفاظ سید خیل,Sayed Khil Darulhefaz,0,0,365,770,1135
3,304,304085,مکتب متوسطه لاله خیل,Lalah Khil Secondary School,0,0,375,567,942
3,304,304086,مکتب سید رحمان شهید,Sayed Rahman Shaheed School,0,1,1230,1507,2738
3,305,305087,مکتب ابتدائیه نسوان مولانا جلال الدین,Mawlana Jalaluddin Mohammad Balkhi Girls Primary *,0,0,455,م3ح2م5د بلچ,978
3,305,305089,لیسه فقی حیدر گلبهار,Faqeer Haider Gulbahar High School,0,0,785,1540,2325
3,305,305091,مسجد ناویا,Nawya Mosque,0,0,83,177,260
3,305,305092,متوسطه عبدالهادی شهید,Abdul Hadi Shaheed Secondary School,0,0,343,429,772
3,305,305093,دارالحفاظ گلبهار,Gulbahar Darul Hefaz,0,1,345,545,891
3,305,305094,لیسه نسوان نمی ۱ ګلبهار,Gulbahar Girls High School No. 1,0,5,826,1293,2124
3,305,305095,لیسه نسوان عشق آباد,Ishq Abad Girls High School,0,0,765,1041,1806
3,305,305096,لیسه نسوان گزر پایان,Guzar e Payan Girls High School,0,0,224,439,663
3,305,305098,مسجد حبیب خیل,Habib Khil Mosque,0,0,618,893,1511
3,305,305099,"مکتب متوسط خلیل زمان, تپه سرخ","Khalil Zaman, Tapah e Surkh Secondary School",0,0,427,907,1334
3,305,305100,لیسه زربیا,Zarbya High School,0,1,415,934,1350
3,305,305101,مسجد آشابه,Ashabah Mosque,0,0,228,0,228
3,305,305102,لیسه ابوحنیفه,Abu Hanifa High School,0,0,289,516,805
3,305,305103,مسجد جامع آهنگران چپ قول,Aahangaran Chap Qoul Jame Mosque,0,0,443,462,905
3,305,305088,مسجد جا می ملک جا ن خیل,Malik Jan Khil Jame Mosque,0,1,649,1531,2181
3,305,305090,مسجد عسی خیل,Eisa Khil Mosque,0,0,219,210,429
3,305,305097,لیسه عالی ذکور جبل السراج,Jablul Seraj Boys High School,0,1,817,2238,3056
3,306,306104,مکتب متوسطه انجیی محمد گل شهید,Eng. Mohammad Gul Shaheed Secondary School,0,11,585,583,1179
3,306,306105,مکتب متوسطه للمی سیک,Lalmi Sabzak Secondary School,0,58,510,507,1075
3,306,306106,مکتب متوسطه حاچ عبدالحکیم,Haji Abdul Karim Secondary School,0,1,587,537,1125
3,306,306107,لیسه تاخمه,Takhma High School,0,1,651,842,1494
3,306,306108,لیسه ذکور سالنګ,Salang Boys High School,0,0,960,1101,2061
3,306,306109,متوسط هیوه بالا,Hunroh e Bala Secondary School,0,0,203,145,348
3,306,306110,لیسه غلام نن شهید,Ghulam Nabi Shaheed High School,0,0,562,412,974
3,306,306111,مکتب متوسطه ویوا,Wewa Secondary School,0,0,466,301,767
3,306,306112,لیسه دوآب,Do Aab High School,0,0,354,340,694
3,306,306113,مکتب اولنگ,Awlang School,0,3,502,530,1035
3,306,306114,لیسه آهنگران,Aahangaran High School,0,0,843,941,1784
3,306,306115,مکتب متوسطه صلاح خان,Salah Khan Secondary School,0,8,135,206,349
3,306,306116,لیسه اورن,Awrti High School,0,28,348,401,777
3,307,307118,مکتب فندقستان,Fanduqistan School,0,0,779,1217,1996
3,307,307119,لیسه حصرت علی,Hazrat Ali High School,0,0,866,3294,4160
3,307,307126,لیسه چهارده,Chahardeh High School,0,0,709,1403,2112
3,307,307127,لیسه فرنجل,Faranjel High School,0,1,827,1562,2390
3,307,307129,مسجد جامع دو آب,Do Aab Jame Mosque,0,1,301,730,1032
3,307,307171,لیسه اناث سیاه گرد,Siagerd Female High School,0,0,292,743,1035
3,308,308135,مکتب انگور دره,Angor Darah School,0,0,0,329,329
3,308,308136,مکتب دندر,Dandar School,0,0,130,572,702
3,308,308137,مکتب متوسطه سیاه سنگ,Syah Sang Secondary School,0,0,0,74,74
3,308,308138,لیسه ذکور اسکندریه,Iskandariah Boys High School,0,0,111,251,362
3,308,308139,مسجد شمال خیل,Shamal Khil Mosque,0,0,0,132,132
3,308,308141,مسجد احمدزی,Ahmadzai Mosque,0,0,750,341,1091
3,308,308142,مسجد ملا احمد خیل,Mullah Ahmad Khil Mosque,0,1,532,655,1188
3,308,308143,مسجد حسن زی,Hasan Zai Mosque,0,0,444,257,701
3,308,308145,مکتب ملا احمد خیل,Qala Khel High School,0,0,457,380,837
3,308,308140,نسوان تریلی,Treli Girls School,0,0,177,251,428
3,309,309146,مکتب قطندر,Qatandar School,0,1,586,569,1156
3,309,309147,لیسه شهید حق بی وند,Shaheed Haqbeen Wand High School,0,0,476,840,1316
3,309,309148,مدرسه شهید امیزاده,Shaheed Amirzadah Madrassah,0,1,1110,1111,2222
3,309,309149,مکتب خواجه پارساه,Khwaja Parsa School,0,0,723,1062,1785
3,309,309150,لیسه نسوان بازار لولنج,Lawlanj Bazzar Girls High School,0,0,328,458,786
3,309,309151,لیسه نسوان حصرت زینب,Hazrat Zainab Girls High School,0,0,119,93,212
3,309,309152,مکتب پایورکی,Payurki School,0,0,73,167,240
3,309,309154,دارالعلوم عبدالروف حجت,Abdul Rouf Hujat Darul Uloom,0,1,435,506,942
3,309,309155,مسجد جامع شینه,Sheenah Jame Mosque,0,1,575,482,1058
3,309,309156,لیسه شهید زلفقار,Shaheed Zulfiqar High School,0,0,382,381,763
3,309,309157,لیسه خدری,Khidri High School,0,0,448,389,837
3,309,309158,لیسه ذکور دهن خاکریز,Dahan e Khakrez Boys High School,0,0,339,407,746
3,309,309153,لیسه شهید علی دوست,Shaheed Ali Dost High School,0,2,321,374,697
3,310,310159,ممی پاواز,Member Pawaz,0,0,135,144,279
3,310,310160,مکتب متوسطه بابرِ,Babur Secondary School,0,0,362,592,954
3,310,310161,لیسه ابوبکر صدیق رض,Abu Baker Sedique High School,0,0,121,725,846
3,310,310162,لیسه عالی اکی شهید,Ali Akbar Shaheed High School,0,0,251,769,1020
3,310,310163,لیسه نوی,Nawai High School,0,1,291,463,755
3,310,310164,مسجد جامع می خوشحال ولی,Mir Khushal Wali Jame Mosque,0,0,189,275,464
3,310,310165,متوسطه حصر ت علی,Hazrat Ali Secondary School,0,1,254,305,560
3,310,310166,لیسه دهن جرف,Dahan e Jarf High School,0,0,348,461,809
3,310,310167,مکتب متوسطه نسوان دره جرف,Darah e Jarf Girls Secondary School,0,0,315,292,607
3,310,310168,خیمه دهن بوتیان,Khaimah (tent) Dahan Botyan,0,0,708,809,1517
3,310,310169,لیسه ذکور امام مهدی,Imam Mahdi Boys High School,0,0,627,605,1232
3,310,310170,خیمه پای کوتل,Khiamah (tent) Pai Kotal,0,0,207,288,495
4,401,401002,تعمن شاروالی,Tameer Sharwali (Municipality Building),0,94,809,3788,4691
4,401,401003,مکتب ناصراباد,Naser Abad School,0,229,197,1352,1778
4,401,401004,مکتب ده افغانان,Deh Afghanan School,0,12,65,1426,1503
4,401,401005,مکتب نایبان,Nayeban School,0,29,471,784,1284
4,401,401006,کلینیک ابراهیم خیل,Ibrahim Khil Clinic,0,5,190,1900,2095
4,401,401007,لیسه ابراهیم خیل,Ibrahim Khil High School,0,0,0,845,845
4,401,401008,خیمه کوه ابراهیم خیل,Khaimah (tent) Koh Ibrahim Khil,0,0,67,1809,1876
4,401,401009,مکتب پل سرخ,Pul E Surkh School,0,0,0,571,571
4,401,401010,مکتب چارکه,Charakah School,0,40,77,1012,1129
4,401,401011,مکتب کهنه خمار,Kuhnah Khumar School,0,22,0,781,803
4,401,401012,مسجد رحمن خیل,Rahman Khil Mosque,0,5,0,779,784
4,401,401013,مکتب اناث کوته اسرو,Kotah e Ashru Girls School,0,67,0,2191,2258
4,401,401001,مکتب اول بابا,Awal Baba School,0,15,304,1840,2159
4,402,402014,لیسه عالی بی بادام,Been Badam High School,0,4,0,1737,1741
4,402,402015,مسجد اندر,Andar Mosque,0,1,580,1112,1693
4,402,402016,لیسه عالی دراب,Durani High School,0,1,310,195,506
4,402,402017,مسجد کلان شادی کلا,Masjid Kalan Shadi Kala Mosque,0,0,0,1729,1729
4,402,402018,مسجد کلان حاجیان,Masjid Kalan Hajian Mosque,0,0,352,1141,1493
4,402,402019,مکتب کان عزت,Kan Ezat School,0,0,267,1701,1968
4,402,402020,سپی مسجد,Speen Masjid Mosque,0,0,439,1141,1580
4,402,402023,مکتب سهاک,Sahak School,0,0,0,1172,1172
4,403,403030,لیسه شهید یعقوب,Shaheed Yaqoubi High School,0,0,390,500,890
4,403,403031,لیسه عالی امام محمد باقر (ع),Imam Mohammad Baqer High School,0,1,442,551,994
4,403,403032,متوسطه غلام دستگن شهید,Ghulam Dastageer Shaheed Secondary School,0,0,547,1101,1648
4,403,403033,مکتب امام عظم,Imam Azam School,0,0,515,577,1092
4,403,403034,متوسطه داولان,Dawlan Secondary School,0,0,502,1127,1629
4,403,403035,متوسطه ب ب عایشه صدیقه,Bibi Ayesha Sediqa Secondary School,0,0,461,1072,1533
4,403,403036,لیسه عالی خواجه محمد ولی,Khwaja Mohammad Wali High School,0,1,462,1537,2000
4,403,403037,متوسطه اسماعیل خیل,Ismael Khil Secondary School,0,1,503,1424,1928
4,403,403038,لیسه عالی زیولات,Zewlat High School,0,0,553,1090,1643
4,403,403039,مکتب مناحمدشاه,Mir Ahmad Shah School,0,0,1173,742,1915
4,404,404043,مسجد قریه کولک,Kolak village Mosque,0,2,507,1692,2201
4,404,404044,منل منگل,Manzil Mangal (Mangal House),0,1,482,1670,2153
4,404,404045,مسجد بازار پنه,Panah Bazzar Mosque,0,0,455,1609,2064
4,404,404046,لیسه عالی عمر فاروق,Omer Farouq High School,0,0,208,1649,1857
4,404,404047,مکتب سر کوه,Sar e Koh School,0,3,546,1706,2255
4,404,404048,مسجد قریه زمانخیل,Zaman Khil Village Mosque,0,2,488,1721,2211
4,404,404051,مدرسه لنگر,Langar Madrassah,0,0,335,1692,2027
4,404,404052,مکتب امبوخاک,AmboKhak School,0,2,310,2029,2341
4,404,404053,مکتب اله سنگ,Alah Sang School,0,2,529,2210,2741
4,404,404055,خانه شخصی ملک قریه,Private house of the Malik of the village,0,0,542,1674,2216
4,405,405065,مکتب لوړه,Lowarrah School,0,5,275,1673,1953
4,405,405067,خیمه در قریه هفت اسیا,Tent in the Haft Aasya village,0,3,0,1688,1691
4,405,405073,مکتب قریه حیدرخیل,Haider Khil Village Mosque,0,1,457,1570,2028
4,405,405074,لیسه عالی سید آباد,Saed Abad High School,0,0,431,1650,2081
4,405,405075,مسجدجامع قلعه سعدالدین,Qalla Saduddin Jame Mosque,0,0,500,1037,1537
4,405,405076,مسجد شاتر,Shater Mosque,0,1,369,1074,1444
4,405,405082,مسجد قریه سی سی,Si Si village Mosque,0,3,0,2060,2063
4,405,405084,لیسه عالی شیخ آباد,Shiekh Abad High School,0,0,295,2035,2330
4,405,405085,لیسه عالی دشت توپ,Dasht Toup High School,0,35,537,1742,2314
4,405,405094,مکتب شش قلعه,Shash Qalla School,0,0,362,1610,1972
4,406,406101,مکتب بلاک حسین,Block Hussaini School,0,3,590,1110,1703
4,406,406102,مسجد قریه نقشبند,Naqshband village Mosque,0,0,254,494,748
4,407,407103,مکتب قلعه سید تیمور,Sayed Taimoor village Mosque,0,1,966,1131,2098
4,407,407104,کلینیک تنک,Teezak Clinic,0,0,1176,1059,2235
4,407,407105,مسجد قریه پائی نقط,Qarya e Payen Nuqat Mosque,0,1,396,468,865
4,407,407106,لیسه گردن دیوار,Gardan Dewar High School,0,0,570,566,1136
4,407,407107,مکتب دولت قولی,Dwalat Quli School,0,0,538,560,1098
4,407,407108,مکتب متوسطه ارگی,Ergeen Secondary School,0,2,559,1112,1673
4,407,407109,مسجد گردی,Gerdi Mosque,0,1,397,560,958
4,407,407110,مکتب ابتدایه دهن آبدره,Dahan Aabdarah Primary School,0,0,893,571,1464
4,407,407111,مکتب جدید سیا بوته,Syah Botah School,0,0,908,972,1880
4,408,408118,کلینیک کلانده,Kalan Deh Clinic,0,0,595,587,1182
4,408,408119,مسجد سنله,Sanzalah Mosque,0,0,586,1161,1747
4,409,409123,مکتب بند بته,Band Botah School,0,0,548,401,949
4,409,409124,مکتب تگاب بنمک,Tagab Beermak School,0,0,664,553,1217
4,409,409125,مکتب کمرگ,Kamarak School,0,0,409,404,813
4,409,409126,مسجد تگاب زیرات,Tagab Zeerat Mosque,0,0,284,283,567
4,409,409127,مدرسه قره قل,Qaraqul Madrassah,0,0,685,630,1315
4,409,409128,مکتب بابکه,Babakah School,0,0,212,248,460
4,409,409129,لیسه دهن اوج,Dahan Awji High School,0,0,170,216,386
4,409,409130,مکتب کجاب علیا,Kujab Ulya School,0,0,125,248,373
4,409,409131,لیسه من هزار کجاب,Mir Hazar Kujab High School,0,0,336,321,657
4,409,409132,دارالعلوم امام محمدباقر,Imam Mohammad Baqer Darul Uloom,0,1,454,515,970
4,409,409133,مکتب باد آسیاب,Bad Aasyab School,0,1,407,587,995
4,409,409134,مکتب سرتاله,Sar Taalah School,0,0,142,202,344
4,409,409135,مسجد درنجوی,Daranjoi Mosque,0,1,260,442,703
4,409,409136,لیسه شهدا,Shuhada High School,0,1,349,367,717
4,409,409138,مکتب راشک,Rashek School,0,0,307,354,661
4,409,409139,مکتب دامن خلیل,Daman Khalil School,0,0,582,912,1494
4,409,409140,لیسه مرک,Marak High School,0,1,966,1027,1994
4,409,409141,لیسه ذکور راقل,Raqul Boys High School,0,1,462,612,1075
4,409,409142,مکتب آب شنوم,Aab Sherom School,0,0,471,536,1007
4,409,409143,لیسه تگاب راموز,Tagab Ramoz High School,0,0,547,561,1108
4,409,409144,لیسه پیتاب راموز,Peetab Ramoz High School,0,0,367,451,818
4,409,409145,مکتب کوتل ملا یعقوب,Kotal Mullah Yaqoub School,0,0,559,832,1391
4,409,409146,مسجد کردن قاده,Kardan Qadah Mosque,0,0,222,126,348
4,409,409147,مکتب جواد جریه خانه,Jawad Jaria Khanah School,0,0,477,479,956
4,409,409148,مکتب سربلاق,Sarbalaq School,0,0,546,638,1184
4,409,409149,مکتب غواص,Ghawas School,0,0,509,565,1074
4,409,409150,مکتب دهن سنگینک,Dahan Sangeenak School,0,0,319,476,795
4,409,409151,مکتب بره خانه,Barah Khanah School,0,11,493,539,1043
4,409,409152,مکتب مهر خانه,Mahar Khanah School,0,0,402,526,928
4,409,409153,مسجد قلعه گردوم,Qalla Gardum Mosque,0,0,504,525,1029
4,409,409154,مسجد ب بولاق عجم,Nai Bolaq Ajam Mosque,0,0,490,501,991
4,409,409155,مکتب سرخ آباد,Surkh Abad School,0,2,640,858,1500
4,409,409156,مدرسه هشت درخت,Hasht Darakht Madrassah,0,0,325,352,677
4,409,409157,مکتب کهنه قلعه,Kuhnah Qalla School,0,0,600,650,1250
4,409,409137,حسینیه عمومی سفید دیوار,Husainia Umoomi Safid Dewar,0,0,525,585,1110
5,501,501001,مرکز سره میاشت,Srah Myasht Markaz (Red Cresent Center),0,483,2191,4715,7389
5,501,501002,ليسه عمر فاروق,Omer Farouq High School,0,1240,2297,9719,13256
5,501,501003,مکتب متوسطه حصارک,Hesarak Secondary School,0,558,115,1151,1824
5,501,501006,مکتب متوسطه پادخواب شانه,Pad Khwab e Shanah Secondary School,0,177,0,2151,2328
5,501,501007,مکتب پس کاریز,Pas e Karez School,0,51,4,159,214
5,501,501008,مکتب متوسطه التمور,Al Tamoor Secondary School,0,715,0,2084,2799
5,501,501009,مکتب چوڼ,Chawnnai School,0,36,0,258,294
5,501,501010,مسجد پشتون آباد,Pashtoon Abad Mosque,0,1169,0,1688,2857
5,501,501011,مکتب آپچکان,Aabchakan School,0,19,0,473,492
5,501,501012,کلینیک شهرک مهاجرین,Shahrak Muhajereen Clinic,0,678,0,2172,2850
5,501,501014,مکتب پورک,Poorak School,0,440,321,1332,2093
5,501,501017,ليسه جهادى کلنگار,Jihadi Kulangar High School,0,37,1462,3915,5414
5,501,501018,لیسه نسوان کمیدان,Kamidan Girls High School,0,2,409,384,795
5,502,502030,ليسه غازى امان الله,Ghazi Amanullah High School,0,1,0,921,922
5,502,502031,لیسه بره کی راجان,Baraki Rajan High School,0,1,134,237,372
5,502,502032,مکتب زحقوم خيل,Zahqoom Khil School,0,2,198,1184,1384
5,503,503041,مکتب مولانا یعقوب چرخ,Mawlana Yaqoub Charkhi School,0,0,0,32,32
5,503,503044,مکتب ډبر,Dabar School,0,969,0,1182,2151
5,504,504045,مکتب دوبندى,Do bandi School,0,1895,1464,4074,7433
5,504,504048,ليسه خوش و مکتب ميانه ده اناث,Khoshi High School and Myanah Deh Girls School,0,4,2583,2877,5464
5,505,505050,مکتب سرخآب,Surkhab School,0,1,1114,1646,2761
5,505,505055,مکتب سفيد سنگ,Safed Sang School,0,267,1587,3229,5083
5,505,505056,مکتب گماران,Gumaran School,0,16,1112,1142,2270
5,505,505060,لیسه عالى محمد آغه,Mohammad Agha High School,0,114,771,3045,3930
5,505,505062,تعمب سابقه ولسوالى,Old Building of the District Administrator,0,103,495,1760,2358
5,505,505063,متوسطه اناث سرخ آباد,Surkh Abad Girls Secondary School,0,21,1128,1742,2891
5,505,505064,مکتب ده نو,Deh Naw School,0,3,1152,3455,4610
5,505,505065,مسجد عقب بازار,Aqab Bazar Mosque,0,23,397,1437,1857
5,505,505067,مکتب اناث مغل خيل,Mughul Khil Girls School,0,318,1343,3378,5039
5,505,505057,مکتب محمد جان خان,Mohammad Jan Khan School,0,365,535,3517,4417
5,506,506068,مکتب خواجه انگور,Khwajah Angor School,0,2,0,39,41
5,507,507078,مکتب چوترا,Chotra School,0,5,829,799,1633
5,507,507080,مکتب اناث و ذکور اکب خيل,Akbar Khil Girls and Boys School,0,10,924,706,1640
5,507,507081,مکتب بب,Babar School,0,27,1097,1140,2264
6,602,602048,مکتب ابتدایه ګردیکس,Gardeks Primary School,7,24,2259,1705,3995
6,602,602049,ثمرخيل مکتب,Samar Khil School,6,34,2839,3342,6221
6,602,602050,لیسه ذکور سراچه عل خان,Saracha Ali Khan Boys High School,1,56,169,1487,1713
6,602,602051,کاریز کبب لیسه,Karez Kabir High School,0,0,415,1107,1522
6,602,602052,هډه مکتب,Hadah School,0,13,534,1060,1607
6,602,602053,وزیر محمد ګل خان لیسه,Wazir Mohammad Gul Khan High School,3,25,616,1091,1735
6,602,602054,شهید سردار محمد داوود خان لیسه,Shaheed Sardar Mohammad Daoud Khan High School,0,102,847,1907,2856
6,602,602055,حاج حلیم مسجد,Haji Haleem Mosque,1,68,580,1537,2186
6,602,602056,حاج حفیظ جومات,Haji Hafeez Mosque,0,3,1209,1828,3040
6,602,602057,محمدی صاحباده لیسه,Mohammadi Sahibzadah High School,2,110,2271,3991,6374
6,602,602058,حضت ابوبکر صدیق لیسه,Hazrat Abu Baker High School,12,43,1129,3387,4571
6,602,602059,قلعه ملخ مکتب,Qalla e Malakh School,0,112,1093,2239,3444
6,602,602060,بانډه جومات,Banda Jomat Mosque,1,121,1058,2167,3347
6,602,602061,مکتب حاج سربلند خان,Haji Sarbiland Khan School,0,25,534,1924,2483
6,602,602062,شهید ملنگ جان عال لیسه,Shaheed Malang Jan High School,1,222,1075,1660,2958
6,602,602063,وچ تنګ لیسه,Wach Tangi High School,0,0,1136,2284,3420
6,602,602064,بحرآباد لیسه,Baher Abad High School,1,99,1123,2503,3726
6,602,602065,جانان خان لیسه,Janan Khan High School,3,111,1400,2442,3956
6,602,602066,دامان جومات,Daman Mosque,2,323,950,2064,3339
6,602,602067,بهسود زراعټ کوپراتیف,Behsoud Agriculture Cooperative,3,112,1695,2753,4563
6,602,602068,ناهيدشهيد مکتب,Nahid Shaheed School,2,21,1651,3406,5080
6,602,602069,د زنګون مکتب,Zangoyee School,1,34,373,657,1065
6,603,603070,مکتب متوسطه سيا سنګ,Syah Sang Secondary School,0,46,592,1132,1770
6,603,603071,ابوبکر صدیق جامع مسجد,Abu Baker Sedique Jame Mosque,0,112,500,1059,1671
6,603,603072,جومات ګنده چشمه,Gandah Chashmah Mosque,0,51,709,562,1322
6,603,603073,کلینیک کوز شیخ مضی,Koz Shiekh Mesri Clinic,0,68,1127,1718,2913
6,603,603074,د غوچکو لیسه,Da Ghochako High School,0,9,1168,1714,2891
6,603,603075,مکتب متوسط لعل قاسم اغا,Lal Qasem Agha Secondary School,1,27,1066,1146,2240
6,603,603076,چکنوري جومات,Chaknoori Mosque,1,18,587,1121,1727
6,603,603077,افغان مینه متوسطه,Afghan Mena Secondry School,0,55,1717,1719,3491
6,603,603078,د کانو صنايعو رياست,Directorate of the Mines Industries,1,39,580,2299,2919
6,603,603079,کلینيک بختان,Bakhtan Clinic,0,46,1133,1141,2320
6,603,603080,ریاست کانان,Reyasat Kanan,1,90,1459,4833,6383
6,603,603081,چارباغ مکتب,Charbagh School,0,28,2160,3728,5916
6,603,603082,پبسيد حسن ګيلان ليسه,Peer Said Hasan Gailani High School,1,15,935,2254,3205
6,603,603083,امرخيل مکتب,Amarkhil School,1,104,1073,2767,3945
6,603,603084,ن ن مريم مکتب,Bibi Mariam School,0,15,1034,2325,3374
6,603,603085,لیسه نسوان شهید محمد اسرف,Shaheed Mohammad Ashraf Girls High School,2,22,1369,1748,3141
6,603,603086,مکتب ابتدائیه قاض فضل محمود,Qazi Fazel Mahmoud Primary School,0,214,783,1612,2609
6,603,603087,لیسه فقرالله,Faqrullah High School,1,56,672,3243,3972
6,603,603088,لیسه اناث,Girls High School,0,82,1124,1175,2381
6,603,603089,سجد جامع,Jame Mosque,0,88,203,731,1022
6,603,603090,لیسه نازنی جبارخیل اناث وذکور,Nazaneen Jabarkhil Girls and Boys High School,0,22,986,2054,3062
6,603,603091,مسجد جامع حضت بلال,Hazrat Bilal Jame Mosque,1,2,263,816,1082
6,603,603092,لیسه نسوان شمسپور,Shamspour Girls High School,0,4,213,898,1115
6,603,603093,سلطان پور جومات,Sultan Pour Mosque,0,15,862,731,1608
6,603,603094,مسجد جامع ابوبکر صدیق,Abu Baker Sedique Jame Mosque,0,108,588,1628,2324
6,603,603095,لیسه نسوان کوشکک,Koshkak Girls High School,0,218,341,1256,1815
6,603,603096,کوز فتح آباد مکتب,Koz Fateh Abad School,0,131,124,732,987
6,603,603098,فتح آباد مکتب,Fateh Abad School,0,75,1140,2281,3496
6,604,604101,ماڼو لیسه,Manno High School,0,1,481,487,969
6,604,604102,سنګينه مکتب,Sangeenah School,1,0,276,1722,1999
6,604,604103,ډاګو نصوانو لیسه,Dago Girls High School,0,0,541,578,1119
6,604,604104,ګراتک مکتب,Gratak School,0,6,582,1137,1725
6,604,604105,څبی متوسطه,Saparai Secondary School,1,1,579,574,1155
6,604,604106,سپی جومات,Speen Jumat Mosque,0,1,1707,509,2217
6,604,604107,بانډو مکتب,Bando School,0,1,461,577,1039
6,604,604108,کاريز جامی جومات,Karez Jame Mosque,1,2,424,580,1007
6,604,604109,حافظانو کل مکتب,Hafezano Kalai School,0,1,472,1123,1596
6,604,604110,کنډي باغ مکتب,Kundi Bagh School,0,0,1654,1639,3293
6,604,604111,متوسطه مکتب,Secondary School,3,1,553,545,1102
6,604,604112,حاج ملوک جومات,Haji Malouk Mosque,0,21,174,493,688
6,604,604113,ملا صاحب جومات,Mullah Sahib Mosque,0,28,301,737,1066
6,604,604114,تر يل مکتب,Tereli School,0,4,146,395,545
6,604,604115,غلام ډاګ مکتب,Ghulam Daag School,2,22,573,1127,1724
6,604,604116,للمه مکتب,Lalma School,0,9,1145,586,1740
6,604,604117,اتفاق مکتب,Itefaq School,0,13,389,798,1200
6,604,604118,جامع جومات دولت زن فامیل,Dawlat Zai Family Jame Mosque,0,34,563,1725,2322
6,604,604119,کوج دولت اباد متوسطه ۍونځ,Kochi Dawlat Abad Secondary School,1,29,1153,562,1745
6,604,604120,څلوزي مکتب,Salozai School,3,17,540,1665,2225
6,604,604121,پټبی مکتب,Paterai School,0,32,565,1131,1728
6,605,605122,زاخيل جومات,Zakhil Mosque,2,1,1170,584,1757
6,605,605123,کلینیک,Clinic,0,5,0,1762,1767
6,605,605124,قلعه اخند لیسه,Qalla e Akhund High School,0,3,1168,1766,2937
6,605,605125,درمان ښوونځ,Darman School,0,2,581,1182,1765
6,605,605126,حضت عمر فارق جامع مدرسه,Hazrat Omer Farouq Jame Mosque,0,0,590,586,1176
6,605,605127,هزاربیک مکتب,Hazar Baig School,0,4,391,829,1224
6,605,605128,شهيد خدايدوست مکتب,Shaheed Khudai Dost School,1,21,634,1297,1953
6,605,605129,مرادعل ليسه,Murad Ali High School,1,20,977,2065,3063
6,605,605130,ښوونځ,School,1,4,583,1003,1591
6,605,605131,سنګرسراي کلنيک,Sangar Sarai Clinic,0,29,631,1307,1967
6,605,605132,سید سرور قادری لیسه,Sayed Sarwar Qaderi High School,0,1,461,1235,1697
6,605,605133,مبزاخیل مکتب,Mirza Khil School,0,50,1103,977,2130
6,605,605134,نادر خان مومند ښوونځ,Nader Khan Momand School,0,15,344,348,707
6,605,605135,توتګ جومات,Totakai Mosque,0,0,587,587,1174
6,605,605136,ماماخیلو لیسه,Mama Khilo High School,0,10,353,480,843
6,605,605137,ماما خيل جومات,Mama Khil Mosque,0,4,1063,1349,2416
6,605,605138,بازیدخیلو جومات,Bazidkhil Mosque,0,27,478,946,1451
6,605,605139,سپدري جومات,Sapedari Mosque,0,35,361,520,916
6,605,605140,مولوی ابراهیم کاموی ښوونځ,Mawlawi Ibrahim Kamawi School,0,7,737,1090,1834
6,605,605141,لنډه بوچ کلنيک,Landa Boch Clinic,0,1,1165,1175,2341
6,605,605143,شبګړ لیسه,Sher Garr High School,0,12,1159,1738,2909
6,605,605144,دار بنګ مکتب,Darbung School,0,8,1172,584,1764
6,605,605145,دکوج کل جامع مسجد,Da Kochi Kali Jame Mosque,0,34,574,556,1164
6,605,605146,ملک شبیندل مکتب,Malik Sherren Dil School,0,44,1155,1716,2915
6,605,605147,ده غازی ښوونځ,Deh Ghazi School,0,4,588,1771,2363
6,605,605142,محمد موسی شفیق لیسه,Mohammad Musa Shafeeq High School,1,4,1178,1744,2927
6,606,606148,سرکنډ مکتب,Sarkund School,0,0,552,643,1195
6,606,606149,برکاشکوټ مکتب,Bar Kash Kot School,0,1,273,933,1207
6,606,606150,کوزکاشکوټ دجینکو مکتب,Koz Kash Kot Girls School,0,0,984,1350,2334
6,606,606151,گوریک مکتب,Goreek School,0,1,340,1086,1427
6,606,606152,ګوریک جومات,Goreek Mosque,0,0,495,343,838
6,606,606153,پاچاه قلعه جومات,Pachahi Qalla Mosque,0,2,383,460,845
6,606,606154,اسلام پور کل جومات,Islam Pour Village Mosque,3,18,256,821,1098
6,606,606155,جينکو مکتب بوډیال کل,Bodialai village Girls School,6,128,1010,1047,2191
6,606,606156,سورچ جامع جومات,Sourach Jame Mosque,0,3,0,542,545
6,606,606157,سرجل مدرسه,Sarjal Madrassah,0,72,151,324,547
6,606,606158,توکل بابا لیسه,Tawkal Baba High School,0,0,203,958,1161
6,606,606159,مرکزي جومات مرکز ښیوه,Markaz Khewah central Mosque,0,3,646,1565,2214
6,606,606160,زرګران کل جومات,Zaragaran village Mosque,0,1,239,521,761
6,606,606161,مرکزي جومات قله ټک,Qalla Tak Marakazi Mosque,1,2,554,774,1331
6,606,606162,هلکانو مکتب,Boys School,0,130,367,832,1329
6,606,606163,شامل کل جومات,Shamil Kali Mosque,0,1,151,382,534
6,606,606164,مکتب گمببی,Gambeeri School,0,14,62,967,1043
6,606,606165,بازارک جومات,Bazarak Mosque,0,109,470,691,1270
6,606,606166,افغان سید جمال الدین لیسه,Sayed Jamaluddin Afghan High School,0,1,579,1084,1664
6,606,606167,کچړه مکتب,Kachrra School,0,354,214,796,1364
6,606,606168,جينکو مکتب شیخان,Shiekhan Girls School,0,11,738,1067,1816
6,606,606169,یاسی بابا جینکو لیسه,Yaseen Baba Girls High School,2,118,1054,1421,2595
6,606,606170,سعید اباد مکتب,Sayed Abad School,0,28,502,1006,1536
6,606,606171,عدلخیل نسوان لیسه,Adel Khil Girls High School,0,8,566,972,1546
6,606,606172,کوز کون جومات,Koz Koti Mosque,1,24,666,1068,1759
6,607,607174,حصارک مزیټ لیسه,Hesarak Mazeeni High School,0,1,513,1100,1614
6,607,607175,قلعه مبج جومات,Qallah Meerji Mosque,0,2,493,1062,1557
6,607,607176,کډي جومات,Kadi Jomat Mosque,1,0,1354,248,1603
6,607,607177,د روغانو مکتب,Da Roghano School,0,3,477,1885,2365
6,607,607178,احداد ابتدائيه مکتب,Ihdad Primary School,0,22,499,1162,1683
6,607,607179,حصارشاه جومات,Hesar Shahi Mosque,1,0,645,2262,2908
6,607,607180,مفټ قلعه جامع جومات,Muftia Qalla Jame Mosque,0,0,199,545,744
6,607,607181,چغری جامع مسجد,Chaghari Jame Mosque,0,0,80,282,362
6,607,607182,حضت عمرفاروق دارالعلوم,Hazrat Omer Farouq Darul Uloom,1,26,1699,1607,3333
6,607,607183,بړو ليسه,Barro High School,0,2,285,887,1174
6,607,607184,بړو د جینکو مکتب,Barro Girls School,0,1,160,541,702
6,607,607185,هجرت اباد لیسه,Hejrat Abad High School,0,153,1136,1526,2815
6,607,607186,ټویل جومات,Tube well Mosque,1,6,553,2247,2807
6,607,607187,حصارشاه کمپ مکتب,Hesar Shahi Camp School,0,164,1566,3250,4980
6,607,607188,ابوبکر صدیق جامع مسجد,Abu Baker Sedique Jame Mosque,1,20,580,1677,2278
6,607,607189,کاترغ جومات,Katarghe Mosque,0,67,528,997,1592
6,607,607190,کان ليسه,Kan High School,1,67,1105,2256,3429
6,607,607191,زاخيل ابتدائيه مکتب,Zakhil Primary School,0,1,773,1576,2350
6,607,607173,مزينه جومات,Mazeenah Mosque,0,1,545,985,1531
6,608,608192,خدر خيل ابتدائيه,Khidar Khil Primary School,0,0,556,1146,1702
6,608,608193,سنګان ابتدائیه مکتب,Sangani Primary School,0,0,463,565,1028
6,608,608194,کمبو ابتدائيه خوازه خيل,"Kambo Primary School, Khwaza Khil",0,13,1109,2315,3437
6,608,608195,ابکو مدرسه,Aabko Madrassah,0,249,467,1611,2327
6,608,608196,جهادي ذکور ليسه,Jihadi Boys High School,0,0,356,1838,2194
6,608,608197,حاج روښان مسجد,Haji Rokhan Mosque,0,0,159,666,825
6,608,608198,حکيم آباد جومات,Hakim Abad Mosque,0,3,392,1922,2317
6,608,608199,قيلغو لیسه مکتب,Qailagho High School,0,2,388,1942,2332
6,608,608200,ملک يارهوتک لیسه,Malik Yar Hotak High School,0,85,704,3608,4397
6,608,608201,کځ نسوانو لیسه,Kaji Girls High School,0,2,630,2237,2869
6,608,608202,سيداعابانډه,Sayed Agha Banda,0,2,432,1082,1516
6,608,608203,لیسه سور ډاګ,Sour Daag High School,0,32,581,1714,2327
6,608,608204,بر بهار لیسه مکتب,Bar Bahar High School,0,3,226,1567,1796
6,608,608205,کوزب هار لیسه,Koz Bahar High School,1,2,685,1945,2633
6,608,608206,کالهخیل وابتدئیه,Kala Khil Primary School,1,3,152,547,703
6,608,608207,لوج لیسه,Lokhi High School,0,38,292,1106,1436
6,608,608208,چمتل جومات,Chamtala Mosque,0,147,641,2127,2915
6,608,608209,لیسه چمتله,Chimtala High School,0,141,583,1017,1741
6,608,608210,کلينیک چمتله کمپ,Chimtala Camp Clinic,0,163,549,1512,2224
6,608,608211,ارغچ جومات,Arghach Mosque,0,56,47,697,800
6,608,608213,زاوه مکتب,Zawah School,0,10,545,1152,1707
6,608,608215,غلام حیدر خان عال لیسه,Ghulam Haider Khan High School,0,1,571,1159,1731
6,608,608216,نوکړخيل مکتب,Nookarr Khil School,0,21,547,1135,1703
6,608,608217,شيخانو کل جومات,Shiekhano Kalai Mosque,0,18,568,1148,1734
6,608,608218,دو ابه مکتب,Do Aabah School,0,27,551,1153,1731
6,608,608219,ټټنګ مکتب,Tatang School,0,39,577,557,1173
6,608,608220,ټټنګ کلینیک,Tatang Clinic,0,34,575,521,1130
6,609,609221,جینکو لیسه,Girls High Shool,0,0,154,550,704
6,609,609222,لوړن جومات,Lowarrtai Mosque,0,0,120,517,637
6,609,609223,سیپای کل جومات,Se Pai Kali Mosque,0,9,163,853,1025
6,609,609224,بټ کوټ مکتب,Bati Kot School,0,3,117,562,682
6,609,609225,دامان جومات,Daman Mosque,0,6,98,416,520
6,609,609227,فارم ۳ جامع جومات,Farm 3 Jame Mosque,0,3,27,179,209
6,609,609228,سپی خوړ جومات,Speen Khowarr Mosque,0,15,53,295,363
6,609,609229,ویال مکتب ۲۵,25 Wyale School,3,59,1064,987,2113
6,609,609230,ګړباوه جومات,Garbawah Mosque,0,333,550,1436,2319
6,609,609231,تکيه مکتب,Takyah School,0,36,582,1136,1754
6,609,609232,ګنديان جومات,Gandyani Mosque,1,145,576,1600,2322
6,609,609233,زيارت جومات,Zyarat Mosque,0,4,583,1739,2326
6,609,609234,چهارده جومات,Chahardehi Mosque,2,2,1624,2307,3935
6,609,609235,مشوان کلينیک,Mashwanni Clinic,0,8,579,1713,2300
6,609,609236,هلکانو ليسه,Boys High School,3,5,1126,579,1713
6,609,609237,کوج بانده جومات,Kochi Banda Mosque,2,310,1131,2605,4048
6,609,609238,باريکاب مکتب,Barekab School,0,82,26,16,124
6,609,609239,صوفیانو کل جومات,Sofyano Kali Mosque,2,186,1633,3361,5182
6,609,609240,جامع جومات فارم ۴,Farm 4 Jame Mosque,0,0,80,383,463
6,609,609241,ګره ن انجونو مکتب,Gerah tai Girls School,0,0,28,266,294
6,610,610243,ابتدائيه مکتب,Primary School,1,1,846,1407,2255
6,610,610244,جاودره جامع مسجد,Jaw Darah Jame Mosque,0,1,100,305,406
6,610,610245,ده بالا ليسه,Deh Bala High School,0,0,270,645,915
6,610,610246,د غوښت ميدان جومات,Da Ghokht Maidan Mosque,0,0,108,321,429
6,610,610247,مریز ذکور لیسه,Mareez Boys High School,0,0,80,336,416
6,610,610248,ياغيبند ابتدائیه مکتب,Yaghiband Primary School,1,3,209,635,848
6,610,610249,مکتب غلټ,Ghalnai School,0,0,356,726,1082
6,610,610250,د ګذاري جومات,Da Guzari Mosque,0,1,388,951,1340
6,610,610251,شپوله هلکانو لیسه,Shpolah Boys High School,0,0,533,704,1237
6,610,610254,پاپی ليسه,Payeen Lycee High School,0,0,15,111,126
6,611,611258,جومات بنګزار,Bangzar Mosque,1,12,549,575,1137
6,611,611259,پایندخیلو جومات,Payenda Khil Mosque,1,0,563,769,1333
6,611,611260,پچبابتدائيه مکتب,Pacheer Primary School,0,4,943,1595,2542
6,611,611261,ملاصاحب جومات,Mullah Saheb Mosque,0,0,574,1145,1719
6,611,611262,بربره جومات,Barbarah Mosque,0,2,346,835,1183
6,611,611263,کوزاګام لیسه,Kozagam High School,0,3,279,1128,1410
6,611,611264,کوزصب جومات,Koz Saber Mosque,0,32,145,667,844
6,611,611265,عمر بن خطاب مدرسه,Omer Bin Khetab Madrassah,0,55,248,1010,1313
6,611,611266,لنډيخيل مکتب,Landi Khil School,0,1,541,1103,1645
6,611,611267,مورک ابتدائيه مکتب,Morkai Primary School,0,0,95,762,857
6,611,611268,مره کلا ابتداییه مکتب,Marah Kala Primary School,0,1,70,242,313
6,611,611269,پچب اګام مکتب,Pacheera Gam School,0,12,200,756,968
6,611,611271,مکتب ګريخيل,Garikhil School,0,0,150,709,859
6,611,611270,بامی خیلو جومات,Bami Khil Mosque,0,114,476,1091,1681
6,612,612273,د انجونو منځټ ښوونځ,Girls Secondary School,2,3,1755,2083,3843
6,612,612274,هلکانو قلعه شاه لیسه,Qalla Shahi Boys High School,0,0,834,1030,1864
6,612,612275,جينکو مکتب قلای شاه,Qalla Shahi Girls School,1,1,1256,770,2028
6,612,612276,برکوټ مکتب,Bar Kot School,0,2,762,823,1587
6,612,612277,مسجد شکیال,Shakyali Mosque,0,0,885,999,1884
6,612,612278,جومات بمبه کوټ,Bambah Kot Mosque,0,0,543,679,1222
6,612,612279,سوتن جومات,Sotan Mosque,0,4,2876,2288,5168
6,612,612280,لمه ټک جومات,Lamah Tak Mosque,1,0,1170,1150,2321
6,612,612281,مجګنډول مکتب,Majgandol School,0,0,1073,1130,2203
6,612,612282,وتران مکتب,Watran School,0,0,1758,1155,2913
6,612,612283,شیمول مسجد,Sheemol Mosque,1,0,1170,1745,2916
6,612,612284,کندک مسجد,Kandak Mosque,1,2,1098,1005,2106
6,612,612285,وایګل مسجد,Waigal Mosque,0,0,1171,1145,2316
6,612,612286,اودرک مکتب,Odrak School,0,4,590,560,1154
6,612,612287,شهید محمود شاه متوسطه,Shaheed Mahmoud Shah Secondary School,0,1,47,453,501
6,612,612288,سروړ جومات,Sarwarr Mosque,0,0,16,285,301
6,613,613289,مکتب,School,1,2,566,579,1148
6,613,613290,لیسه اناث پورشاه خیل,Pourshah Khil Girls High School,0,0,1726,577,2303
6,613,613291,مکتب ابتدائیه پورشاه خیل,Pourshah Khil Primary School,0,0,0,576,576
6,613,613292,لوي جومات باندوک,Loy Jomat Bandook Mosque,0,0,585,1173,1758
6,613,613293,لوي جومات سيپاي کل,Loy Jomat Se Pai Kalai Mosque,0,0,566,481,1047
6,613,613294,آزاد میدان سيپاي کل,Open ground Se pai Kalai,0,1,590,573,1164
6,613,613295,لیسه ذکور پورشاه خیل,Pourshah Khil Boys High School,0,0,575,584,1159
6,613,613296,متوسطه مکتب سيد احمدخيل,Sayed Ahmad Khil Secondary School,1,2,1125,2314,3442
6,613,613297,دوان کل ميدان,Dwani Kali Maidan (Dwani Kali Ground),0,38,775,1041,1854
6,613,613298,دوان کل لوي جومات,Dwani Kali Loy Jomat Mosque,0,1,770,1069,1840
6,613,613299,عطاخان ميدان,Atta Khan Maidan (Atta Khan Ground),0,0,498,1105,1603
6,613,613300,عطاخان لوی جومات,Atta Khan Loy Jomat Mosque,0,11,677,1216,1904
6,613,613301,کوټ ليسه,Kot High School,0,0,1080,2073,3153
6,613,613302,حيدرخان لوي جومات,Haidar Khani Loy Jomat Mosque,0,0,213,1094,1307
6,613,613303,ازاد میدان,Azad Maidan (Open Ground),0,1,225,0,226
6,613,613304,ترل ميدان,Tarli Maidan (Tarli Ground),0,1,291,572,864
6,613,613305,تریل زوړ لوي جومات,Tareli Old Mosque,0,0,527,820,1347
6,614,614306,سربند ابتدائيه مکتب,Sarband Primary School,1,2,369,761,1133
6,614,614307,اړج جومات,Arrkhi Mosque,0,1,800,1660,2461
6,614,614308,ګوشټ انجونو متوسطه,Goshtah Girls Secondary School,1,1,578,582,1162
6,614,614309,حميد مومند مکتب,Hameed Momand School,0,1,66,508,575
6,614,614310,ملا رحمت بابا د انجونو لیسه,Mullah Rahmat Ba Ba Girls High School,0,1,1172,1362,2535
6,614,614311,يعقوب خيل جومات,Yaqoub Khil Mosque,0,1,734,898,1633
6,614,614312,ورسک مکتب,Warsak School,0,1,526,668,1195
6,614,614314,زیارت ګاډ مکتب,Zyarat Gaad School,0,0,531,599,1130
6,614,614315,شالالا مکتب,Shah Lala School,0,1,304,412,717
6,614,614316,تورگان مکتب,Torgani School,0,1,504,532,1037
6,614,614317,دروخيل مکتب,Darukhil School,0,0,633,589,1222
6,614,614318,دلعلو کل جومات,Da Lalo Kali Mosque,0,0,563,695,1258
6,614,614319,ماماخیل مکتب,Mamakhil School,0,5,1083,774,1862
6,614,614320,ډاګ کل ابتدايه مکتب,Daag Kali Primary School,0,0,1157,906,2063
6,614,614313,راغه کل جومات,Aragha Kali Mosque,0,0,315,284,599
6,615,615321,زري خوله جومات,Zaree Khola Jomat Mosque,0,0,593,2095,2688
6,615,615324,بر اکب خيل میاج جومات,Bar Akbar Khil Miajee Mosque,0,3,409,405,817
6,615,615325,براکب خيل جومات,Bar Akbar Khil Mosque,0,1,1708,1776,3485
6,615,615326,شهید ګل اصغر لیسه,Shaheed Gul Asghar High School,0,0,21,380,401
6,615,615327,مبانو کل جومات,Meerano Kalai Mosque,0,0,85,1628,1713
6,615,615328,ګړوکو زیارت مدرسه,Garroko Zyarat Madrassah,0,1,344,1459,1804
6,615,615329,بندرخوله جامع جومات,Bandar Kholah Jame Mosque,0,0,488,1724,2212
6,615,615330,دپبوخیلو نوی جامع جومات,Peero Khil New Jame Mosque,0,0,21,550,571
6,615,615331,ده سرک کهنه لیسه,Da Sarak Kuhna High School,0,0,113,881,994
6,615,615332,خوار اخنذاده ګان جامع مسجد,Khwar Akhundzadagan Jame Mosque,0,1,199,969,1169
6,615,615333,خادي راغه خوږه خیل مسجد,Khadi Ragha Khwaga Khil Mosque,0,0,0,793,793
6,615,615339,زوړ جومات,Zorr Jomat Mosque (OLD Mosque),0,0,52,0,52
6,615,615346,ګاوي کل جومات,Gawi Kali Mosque,1,26,774,517,1318
6,615,615347,راغه کل جومات,Raagha Kali Mosque,1,0,250,436,687
6,615,615348,پیښ ابتدائیه ښوونځ,Pekhi Primary School,1,0,470,1608,2079
6,615,615349,پییښ دوکان کل جومات,Pekhi Dokan Kali Mosque,0,0,0,1080,1080
6,616,616358,کنګالان جومات,Kangalan Mosque,0,0,224,1011,1235
6,616,616359,ډاګه مکتب,Dagah School,0,2,354,1287,1643
6,616,616360,حضت بلال مدرسه,Hazrat Bilal Madrassah,0,1,273,1049,1323
6,616,616361,الفتځ لیسه,Al Fatah High School,0,2,541,1615,2158
6,616,616362,تبلغیانو مرکز,Tableeghiano Markaz (Tableeghi center),0,0,41,303,344
6,616,616363,هسپتال جومات,Hospital Mosque,1,81,1138,2815,4035
6,616,616364,مکتب ٢٨ وياله,28 Weyalah School,0,12,325,547,884
6,616,616365,مسجد سپی پل,Speen Pul Mosque,2,25,479,1160,1666
6,616,616366,لیسه مار کو,Mar Koh High School,0,100,1062,2883,4045
6,616,616367,د 26 ویال لیسه,26 Weyalah High School,0,12,118,563,693
6,616,616368,حضت بلال جومات,Hazrat Bilal Mosque,1,4,1016,2242,3263
6,616,616369,ګولان لیسه,Golayee High School,0,190,52,95,337
6,616,616370,سياچوب جومات,Syah Chob Mosque,0,8,1179,2340,3527
6,617,617371,طورخم کلینیک,Torkham Clinic,0,30,524,1117,1671
6,617,617372,جومات کمه ډکه,Kamah Dagah Mosque,0,2,186,216,404
6,617,617373,دکه لیسه,Dakah High School,0,140,1358,1698,3196
6,617,617374,صلح ازادی تجارن لیسه,Sulh e Azadi Tujarati High School,2,91,787,1572,2452
6,617,617375,اوتمانزن جومات,Utmanzai Mosque,0,38,1176,1151,2365
6,617,617376,ګردي غوث لیسه,Gerdi Ghous High School,0,33,1229,2944,4206
6,617,617377,جومات کولال کل,Kolali Kali Mosque,0,23,1146,1737,2906
6,617,617378,غزک لیسه,Ghazgai High School,0,1,576,1397,1974
6,617,617379,کنډو کل جومات,Kandaw Kali Mosque,0,1,142,428,571
6,617,617380,هزارناو لیسه,Hazar Naw High School,0,0,330,1320,1650
6,617,617381,پاس کل پاچا خیل جومات,Pass Kalai Pacha Khil Mosque,1,0,242,1208,1451
6,617,617382,هديري کل جومات,Hadeere Kali Mosque,0,0,188,704,892
6,617,617383,ايمل خان ليسه,Imal Khan High School,0,3,646,1813,2462
6,617,617387,عل جان قلعه جومات,Ali Jan Qalla Mosque,1,1,400,1355,1757
6,617,617388,دامان کل سپی جومات,Daman Kali Speen Jomat Mosque,0,0,207,917,1124
6,618,618390,شبآباد ليسه,Sher Abad High School,0,3,1023,2411,3437
6,618,618392,ګل ډاګ لیسه,Gul Daag High School,0,1,974,2210,3185
6,618,618393,چکنور لیسه,Chaknoor High School,0,3,1442,1630,3075
6,618,618391,عید ګاه مسجد,Eidgah Mosque,2,3,828,2544,3377
6,619,619399,ماماخيل ليسه,Mama Khil High School,0,0,566,1151,1717
6,620,620413,جاې سرجومات,Jai Sar Mosque,0,0,103,179,282
6,620,620414,مورچل کل میدان,Morchal Kali Maidan (Morchal village ground),0,0,252,532,784
6,620,620415,ترج ابتدائیه,Tarkhi Primary School,1,0,175,368,544
6,620,620416,سپی جومات ميدان,Speen Jomat Maidan (Speen Jomat Mosque ground),0,0,399,836,1235
6,620,620417,سرون لیسه,Surobi High School,0,1,428,606,1035
6,620,620418,نضت جومات,Nasrat Mosque,0,0,408,1100,1508
6,620,620419,غرن لنډی جومات,Gharbi Landai Mosque,0,0,352,1272,1624
6,620,620420,زړه لنډی جومات,Zarrah Landai Mosque,8,4,4724,4120,8856
6,621,621426,سياه اب مکتب,Syah Aab School,1,47,534,529,1111
6,621,621427,ملک ديره,Malik Derah (Malik’s House),0,70,568,523,1161
6,621,621428,راغه مکتب,Aragha School,0,0,66,455,521
6,621,621430,راغه جومات,Raagha Mosque,0,1,0,567,568
6,621,621431,سيا اب,Syah Aab,2,1,1096,1169,2268
6,622,622446,سره ګټه منځټ ښوونځ,Srah Gatah Secondary School,0,0,514,1074,1588
6,622,622447,چنار متو سطه ښوونځ,Chinar Secondary School,0,17,588,1733,2338
6,622,622448,کوزی وج لګډی مسجد,Koze Wachi Lagdai Mosque,0,0,1106,1136,2242
6,622,622449,مکتب څڅون,Sasobai School,0,1,568,1136,1705
6,622,622450,کل ګړوکو جامع مسجد,Garrhoko Kali Jame Mosque,0,27,571,1128,1726
6,622,622451,خوړ مينه جامع مسجد,Khowarr Menah Jame Mosque,1,0,1147,1702,2850
6,622,622452,انځرکل منځټ ښوونځ,Enzar Kalai Secondary School,0,0,209,998,1207
6,622,622453,شولګرښوونځ,Sholgar School,1,1,305,981,1288
6,622,622454,سورکنډاو مسجد,Soor Kandaw Mosque,0,1,205,981,1187
6,622,622455,شګ جامع مسجد,Shagai Jame Mosque,1,0,484,1046,1531
6,622,622456,زيارت کل مسجد,Zyarat Kali Mosque,0,1,463,948,1412
6,622,622457,غوزک ابتدايه ښوونځ,Ghozgai Primary School,0,0,340,929,1269
6,623,623334,معروف چينه جامع جومات,Marouf Cheenah Jame Mosque,0,20,1194,2041,3255
6,623,623337,میدانک جامع جومات,Maidanak Jame Mosque,0,0,151,631,782
6,623,623338,د کهی ليسه,Da Kahi High School,1,0,461,1108,1570
6,623,623341,صندوق کل جامع جومات,Sandooq Kali Jame Mosque,0,2,141,509,652
6,623,623342,د وچ کوټیو او دولت خیلوجومات,Da Wach Kotaio aw Dawlat Khilo Mosque,0,1,87,447,535
6,623,623343,عل اکاخیل زوړ جومات,Ali Aka Khil Old Mosque,0,1,43,611,655
6,623,623344,اچی لیسه,Acheen High School,1,0,141,839,981
6,623,623345,تريل ابتدائيه مکتب,Tereli Primary School,0,0,74,457,531
6,623,623350,مولا صیب زیارت جومات,Mullah Saeb Zyarat Mosque,0,0,52,288,340
6,623,623351,اسد خیلو مکتب,Asad Khilo School,0,0,28,213,241
6,623,623352,الياس بابا مکتب,Ilyas Ba Ba School,1,2,842,1132,1977
6,623,623353,مست بابا مکتب,Mast Ba Ba School,0,0,787,1174,1961
6,623,623355,شوکان ابتدائيه مکتب,Shokannai Primary School,0,8,1059,1647,2714
6,60101,601001,عبدالرحيم مکتب,Abdul Rahim School,1,6,550,1119,1676
6,60101,601002,عبدالوکيل لیسه,Abdul Wakeel High School,9,96,613,2905,3623
6,60101,601003,حضت ابو قتاده جامع جومات,Hazrat Abu Qatadah Jame Mosque,0,11,848,1544,2403
6,60101,601004,کمپونو جومات,Campono Mosque,0,13,689,2085,2787
6,60101,601005,مکتب صدیق الله ریشی,Sediqullah Reshteen School,7,15,722,1567,2311
6,60101,601006,سپی جومات,Speen Jumat Mosque,0,222,258,3260,3740
6,60101,601007,سراج العمارات باغ,Serajul Emarat garden,0,28,248,1362,1638
6,60101,601047,عبدالله بن مسعود جومات,Abdullah Bin Maoud Mosque,34,195,1628,2241,4098
6,60102,601008,انګور باغ جامع جومات,Angor Bagh Jame Mosque,2,144,1706,5173,7025
6,60102,601009,ګمرک جومات,Gumrak Mosque,3,120,126,4563,4812
6,60102,601010,امبشهيد باغ,Ameer Shaheed Garden,1,59,475,4041,4576
6,60102,601011,ن ن حواليسه,Bibi Hawa High School,0,30,1609,2745,4384
6,60102,601012,مياعمر مکتب,Mia Omer School,1,32,713,2878,3624
6,60102,601013,اتفاق جومات,Itefaq Mosque,1,63,1147,3181,4392
6,60103,601014,عربانو مکتب,Arabano School,0,23,1046,1536,2605
6,60103,601015,تقوا جومات,Taqwa Mosque,0,6,393,1350,1749
6,60103,601016,امام بخاري ليسه,Imam Bukhari High School,0,101,835,2435,3371
6,60103,601017,لیسه تجربوی,Lycee Tajrubawi (Experimental High School),3,33,2103,5188,7327
6,60103,601018,ن ن زينب مکتب,Bibi Zainab School,0,35,2904,2252,5191
6,60103,601019,چکنوري ليسه,Chaknori High School,2,91,1109,3607,4809
6,60103,601020,د ښځو چارو رياست,Directorate of Women Affairs,0,23,823,745,1591
6,60103,601021,مهبلام جامع جومات,Mehtarlam Jame Mosque,0,34,884,3485,4403
6,60104,601022,مسجد ظفر آباد,Zafar Abad Mosque,2,16,654,945,1617
6,60104,601023,مجبور آباد جامع جومات,Majboor Abad Jame Mosque,1,22,0,2267,2290
6,60104,601024,مجبور آباد مکتب,Majboor Abad School,1,44,1471,1148,2664
6,60104,601025,ابياري رياست,Irrigation Directorate,0,14,449,1268,1731
6,60104,601026,عبدالله بن مسعودجامع جومات,Abdullah Bin Masoud Jame Mosque,0,6,0,545,551
6,60104,601027,مسجد بب اکمالان,Base Ikmalati Mosque,3,315,2120,6236,8674
6,60104,601028,زراعت ليسه,Zarat High School (Agricultur Lycee),0,5,159,719,883
6,60104,601029,نضت ليسه,Nusrat High School,0,9,675,1809,2493
6,60104,601030,دن ن عایشه لیسه,Bibi Ayesha High School,1,142,2295,2505,4943
6,60104,601031,عيد ګاه جومات,Eidgah Mosque,4,31,827,1722,2584
6,60104,601032,ننګرهار ليسه,Nangarhar High School,2,46,320,2385,2753
6,60104,601033,شانزده فاميل جومات,Shanzdah Family Mosque,4,13,603,2564,3184
6,60104,601034,چهل مبه جومات,Chehel Metra Mosque,0,30,484,1615,2129
6,60104,601035,زيړ جومات,Zerr Jomat Mosque,1,116,1272,2812,4201
6,60105,601036,دامام ابوحنیفه جومات,Imam Abu Hanifa Mosque,0,174,772,1741,2687
6,60105,601037,دحج اوقاف ریاست جومات,Directorate of Haj and Endowment Mosque,99,33,291,2604,3027
6,60105,601038,نازوانا مکتب,Nazo Ana School,0,35,2369,1210,3614
6,60105,601039,استقلال مکتب,Isteqlal School,0,35,306,3262,3603
6,60105,601040,دارلمعلمی,Darul Malemeen (Institute of Teacher Training),2,25,835,1105,1967
6,60105,601041,کوچيانو جومات,Kochiano Jomat Mosque,0,211,646,3385,4242
6,60106,601042,حضت عباس ابتدایه,Hazrat Abas Primary School,0,547,713,2941,4201
6,60106,601043,دشبمی ناحټ تعمب,Nahia (District) no. 6 Building,0,44,1511,2802,4357
6,60106,601044,نجم الجهاد لیسه,Najmul Jihad School,3,283,1503,4170,5959
6,60106,601045,اول حص ابتدایه مکتب,Awale Hesae Primary School,2,389,508,3038,3937
6,60106,601046,مسجد شهرک سیاف,Shahrak Sayaf Mosque,0,159,254,844,1257
7,701,701001,مستورې لېسه,Mastore High School,0,21,2998,8552,11571
7,701,701002,د شهرنو لمړن تجربوي ښوونځ,Shahr e Naw Experimental School,0,6,1452,3869,5327
7,701,701003,دعل خېلو ښوونځ,Ali Khil School,0,31,916,3726,4673
7,701,701004,کتب زی مکتب,Kutub Zai School,0,2,543,1198,1743
7,701,701005,د شیګړ ښوونځ,Sher Garr School,0,0,402,1186,1588
7,701,701006,د ده زيارت ښوونځ,Deh Zyarat School,0,42,958,2659,3659
7,701,701007,د مهاجرينو کمپ ښوونځ,Refugees Camp School,0,30,1185,2285,3500
7,701,701008,د حېدرخان کلکوټ ښوونځ,Haider Khani Kalkot School,0,7,390,2523,2920
7,701,701009,د چارده ښوونځ,Chahar Dehi School,0,14,705,1297,2016
7,701,701010,د شمنګل جومات,Shamangul Mosque,0,6,313,827,1146
7,701,701011,د تیګړېو جومات,Teer Garai Mosque,0,3,567,1717,2287
7,701,701012,د ګمی دکل جومات اوښوونځ,Gameen Kalai Mosque and School,0,4,1457,1801,3262
7,701,701013,د چلمټيو ښوونځ,Chalmatai School,0,1,338,1529,1868
7,701,701014,دسه صدې دهلکانواونجونو ښوونځ,Sehsadi Boys and Girls School,0,17,1144,2764,3925
7,701,701015,دهرمل دهلکانو او نجونو ښوونځ,Harmal Boys and Girls School,0,3,424,1512,1939
7,701,701016,د شمټيو جومات,Shamatio Mosque,0,39,558,597,1194
7,701,701017,د کچور ښوونځ,Kachoor School,0,0,297,899,1196
7,701,701018,د ګلارام ښوونځ,Gularam School,0,2,0,262,264
7,701,701019,دکټل دنجونوښوونځ,Katal Girls School,0,7,755,1633,2395
7,701,701021,د بدیع آباد مسجد,Badee Abad Mosque,0,1,389,1524,1914
7,701,701022,د کرنج دکل جومات,Karanj Village Mosque,0,0,0,71,71
7,701,701023,دکرنج دکوچيانو جومات,Karanj Kochiano Mosque,0,11,0,48,59
7,701,701024,دعليشنګ دکل ښوونځ,Alishang Village School,0,3,327,864,1194
7,701,701025,د ډيوې ښوونځ,Dewah School,0,0,139,650,789
7,701,701124,مکتب متوسطه شهرک سلطان غازی,Sultan Ghazi Secondary School,0,69,1209,2898,4176
7,701,701020,دشهيد مولوي حبيب رحمان لېسه,Shaheed Mawlawi Habib Rahman High School,0,2,262,1334,1598
7,702,702026,اسلام آباد کشمنډ مکتب,Islamabad Kashmand School,0,568,96,101,765
7,702,702027,دزعفران دکل تالار,Da Zafran da Kali Talar (Zafran Village Hall),0,751,1734,1792,4277
7,702,702028,دنهرریم ښوونځ,Naher Reem School,0,1001,565,721,2287
7,702,702029,د ګمبیي د احمدزيو د کوچيانو جومات,"Gambiree, Ahmadzai Kochi Mosque",0,276,924,1251,2451
7,702,702030,گل غوندی مکتب,Gul Ghundi School,0,54,2044,2583,4681
7,702,702031,دګل پاچاالفت لېسه,Gul Pacha Ulfat High School,0,52,1762,2859,4673
7,702,702032,د پاچا کلا جومات,Pacha Kala Mosque,0,62,775,1394,2231
7,702,702033,دچهارباغ دهلکانو لیسه,Chahar Bagh Boys High School,0,105,463,1974,2542
7,702,702034,دسلطان ويس بابا ښونځ,Sultan Wais Baba School,0,41,539,1713,2293
7,702,702035,دصوان ښونځ,Swati School,0,0,297,776,1073
7,702,702036,ددړه غرښوونځ,Darah Ghar School,0,1,415,1235,1651
7,702,702037,دعزیزخان کڅ ښارکون ښوونځ,Aziz Khan Kas Khargotati School,0,68,1440,2038,3546
7,702,702038,دعبدالرحیم زی دنجونو ښونځ,Abdul Rahimzai Girls School,0,13,509,1312,1834
7,702,702039,دسرخکانو لېسه,Surkhakan High School,0,157,1955,3186,5298
7,702,702040,دکمالپور اوښوونځ,Kamal Pour School,0,1,273,1576,1850
7,702,702041,دقرغيودهلکانوعال لېسه,Qarghayee Boys High School,0,19,984,2143,3146
7,702,702042,د مشه خيلو دهلکانو ليسه,Masha Khil Boys High School,0,19,571,1020,1610
7,702,702043,د مندروړ لېسه اولمړن ښوونځ,Mandarwarr High School and Primary School,0,17,1374,2239,3630
7,702,702044,دفرمانخیلو مکتب,Farman Khil School,0,11,26,1015,1052
7,702,702045,زيړان کل جامع جومات او کلینیک,Zerani village Mosque and Clinic,0,375,1559,1533,3467
7,702,702046,دکاکڅ ښوونځ,Ka Kas School,0,94,1974,2901,4969
7,703,703051,داسلام آباد دهلکانو او نجونو ښوونځ,Islamabad Boys and Girls School,0,6,488,1083,1577
7,703,703052,دترنګ ښوونځ,Tarang School,0,4,297,1371,1672
7,703,703054,دشکرمان ښوونځ,Shukurman School,0,18,193,620,831
7,703,703056,دکوټوال خنډودکل جومات اوعامه برنډه,Kotwal Khando village Mosque and hall,0,5,519,2184,2708
7,703,703057,د وطن ګټو ښوونځ,Watan Gato School,0,58,391,797,1246
7,703,703058,د مياعبدالکريم لېسۀ,Mia Abdul Karim High School,0,2,120,253,375
7,703,703060,دغازی اباد ښونځ,Ghazi Abad School,0,413,549,596,1558
7,703,703065,د نجيل ښوونځ,Najeel School,0,24,333,1084,1441
7,704,704072,مسجد جامع چینچار پول,Chinchar Pul Jame Mosque,0,4,449,1909,2362
7,704,704075,دکندی انجونو مکتب,Kundi Girls School,0,3,417,1160,1580
7,704,704076,درجان ښوونځ,Rejaee School,0,1,305,900,1206
7,704,704091,مکتب لوکار,Lokar School,0,6,318,1072,1396
7,704,704092,دمنګو ښوونځ,Mango School,0,13,193,547,753
7,704,704094,د سندروا ښوونځ,Sanderwa School,0,5,0,375,380
7,704,704101,دانجنیشیمحمد لېسه اودنجونوښوون,Eng. Sher Mohammad High School and Girls School,0,10,639,2851,3500
7,704,704102,د سخرې دکل جومات,Sakhra village Mosque,0,6,223,784,1013
7,705,705103,د زرکمر ښوونځ,Zar Kamar School,0,30,219,916,1165
7,705,705104,نوړه کل جومات,Norrah Village Mosque,0,0,21,78,99
7,705,705105,دولت شاه مسجد,Dawlat Shah Mosque,0,0,207,319,526
7,705,705106,افغان کالون ښوونځ,Afghan Colony School,0,1,166,671,838
7,705,705108,ویس جومات,Wais Mosque,0,0,350,536,886
7,705,705112,نيو بالادي مکتب,New Bala Deh School,0,100,117,754,971
7,705,705113,د کېل جومات,Keel Mosque,0,0,447,610,1057
7,705,705114,د نيل خان جومات,Neel Khan Mosque,0,0,0,873,873
7,705,705116,د کاراک جومات,Karak Mosque,0,0,739,784,1523
7,705,705117,چاشدار مکتب,Chashdar School,0,0,0,309,309
7,705,705118,دسنګ پیتک مکتب,Sang Peetak School,0,0,313,374,687
7,705,705119,د پیتک جومات,Peetak Mosque,0,1,443,1047,1491
7,705,705120,د ګمنډوک جومات,Gamandook Mosque,0,0,110,380,490
7,705,705111,مسجد,Mosque,0,4,134,807,945
7,706,706121,تامی زرعت,Agriculture Department’s Building,0,0,7,492,499
8,801,801001,مسجد مارشال فهیم,Marshal Fahim Mosque,0,1,756,2056,2813
8,801,801002,مسجد خانی,Khaniz Mosque,0,0,210,738,948
8,801,801003,مدرسه جامع خانی,Khaniz Jame Madrassah,0,0,187,775,962
8,801,801004,مسجد ده تلخه,Deh Talkha Mosque,0,0,437,760,1197
8,801,801005,لیسه بازارک,Bazarak High School,0,1,566,1324,1891
8,801,801006,مکتب متوسطه کوه منجهور,Koh E Manjhor Secondary School,0,0,179,529,708
8,801,801007,مکتب متوسط ملسیه,Malsia Secondary School,0,1,529,587,1117
8,801,801008,مسجد جامع بادقول,Badqul Jame Mosque,0,0,177,310,487
8,801,801009,مسجد جامع سنگانه,Sangana Jame Mosque,0,0,168,219,387
8,801,801010,مسجد جامع بهارک,Baharak Jame Mosque,0,1,143,319,463
8,801,801011,مکتب متوسطه پارنده,Parendah Secondary School,0,0,356,476,832
8,801,801018,مکتب کنده,Kandah School,0,0,321,571,892
8,802,802012,مسجد حصارک,Hesarak Mosque,0,0,376,369,745
8,802,802013,مسجد مرشتان,Marshetan Mosque,0,0,164,406,570
8,802,802014,مسجد درخیل,Darkhil Mosque,0,0,247,269,516
8,802,802015,لیسه نسوان قابضان,Qabezan Girls High School,0,0,597,488,1085
8,802,802016,لیسه ذکور رخه,Rukha High School,0,0,195,707,902
8,802,802017,مکتب متوسطه دخیانه داکه,Dakah Girls Secondary School,0,0,332,393,725
8,802,802019,لیسه نسوان پیاوشت,Pyawesht Girls High School,0,0,261,353,614
8,802,802020,مکتب ابتدائیه چمالورده,Chamalwerdah Primary School,0,0,225,209,434
8,803,803021,مکتب ابتدایه خواجه فرهاد ولی,Khwajah Farhad Wali Primary School,0,0,359,515,874
8,803,803022,مکتب نسوان عبدالله خیل,Abdullah Khil Girls School,0,1,285,310,596
8,803,803023,مکتب ملک مرزای شهید,Malik Mirza e Shaheed School,0,1,778,897,1676
8,803,803024,مکتب تند خو,Tund Khu School,0,0,0,479,479
8,803,803025,مکتب طارق,Tariq School,0,0,106,139,245
8,803,803026,مکتب پسگران,Pasgaran School,0,0,234,330,564
8,803,803027,مدرسه دین کرامان,Keraman Religious Madrassah,0,0,195,316,511
8,803,803028,لیسه نسوان کرامان,Keraman,0,0,135,155,290
8,803,803029,مسجد اسکنیاز,Askanyaz Mosque,0,0,183,185,368
8,803,803030,مسجد دهن سخ,Dahan Sakh Mosque,0,0,343,323,666
8,803,803031,مکتب ابتدایه عثمان غن,Usman Ghani Primary School,0,0,164,118,282
8,803,803032,مکتب متوسطه نسوان خواجه عبدالعز,Khwajah Abdul Azi Girls Secondary School,0,1,461,475,937
8,803,803033,مکتب نسوان تمبنه,Tambanah Girls High School,0,1,331,468,800
8,804,804034,دارالعلوم مارشال محمد قسیم فهیم,Marshal Mohammad Qaseem Fahim Darul Uloom,0,2,527,698,1227
8,804,804035,لیسه ذکورشابه,Shabah Boys High School,0,0,297,447,744
8,804,804036,مکتب حنف زنه,Hanafi Zanah School,0,0,256,401,657
8,804,804037,مسجد جامع پشغور,Peshghor Jame Mosque,0,1,464,675,1140
8,804,804038,مکتب خاتم الانبیا,Khatimul Anbya School,0,0,314,232,546
8,804,804039,مدرسه خارو,Kharo Madrassah,0,3,607,584,1194
8,804,804040,مسجد جامع برجمن,Barjman Jame Mosque,0,0,121,413,534
8,804,804041,مدرسه خنج,Khinj Madrassah,0,1,375,567,943
8,804,804042,مدرسه پاوات,Pawat Madrassah,0,0,156,202,358
8,804,804043,لیسه ذکور متاء,Matta Boys High School,0,1,416,314,731
8,804,804044,مسجد جامع عبدالله بن مسعود,Abdullah Bin Masoud Jame Mosque,0,0,102,77,179
8,804,804045,مکتب ابتدائیه مکن,Makani Primary School,0,0,489,519,1008
8,804,804046,مسجدجامع سفیدچهر,Safid Chahr Jame Mosque,0,1,539,984,1524
8,804,804047,مکتب محمد پناه شهید,Mohammad Panah Shaheed School,0,0,221,582,803
8,804,804048,مسجد غنجو,Ghanjo Mosque,0,0,483,547,1030
8,804,804049,مدرسه دشت ریوت,Dasht Reot Madrassah,0,0,397,930,1327
8,804,804050,مسجد درنامه,Dur Namah Mosque,0,0,512,560,1072
8,805,805051,مکتب متوسطه ذکور دربند,Darband Boys Secondary School,0,1,219,634,854
8,805,805052,لیسه نسوان فراج,Faraj Girls High School,0,0,261,361,622
8,805,805053,مکتب سنگی,Sangeen School,0,0,171,398,569
8,805,805054,مکتب متوسط زمانکور,Zamankor Secondary School,0,0,990,625,1615
8,805,805055,مکتب ذکور,Boys School,0,1,1125,1585,2711
8,805,805056,مسجد چمن قلعچه,Chaman Qallacha Mosque,0,0,303,231,534
8,805,805057,مدرسه نور,Noor Madrassah,0,0,308,801,1109
8,805,805058,مکتب متوسطه شوفه,Shofah Secondary School,0,0,19,252,271
8,805,805059,مدرسه گنه,Ganah Madrassah,0,0,111,254,365
8,805,805060,مکتب نسوان دشتک,Dashtak Girls School,0,2,815,1377,2194
8,805,805061,لیسه نسوان تاواخ,Tawakh Girls High School,0,0,360,453,813
8,806,806062,مکتب کورابه,Korabah School,0,0,727,815,1542
8,806,806064,مسجد سنگ لخشان,Sang Lakhshan Mosque,0,0,101,81,182
8,806,806065,مسجد سغه وار,Sagha War Mosque,0,0,431,429,860
8,806,806066,مسجد جانان جوی,Janan Joi Mosque,0,0,625,469,1094
8,806,806067,مسجد چیلانک,Chelanak Mosque,0,0,164,178,342
8,806,806063,کلینیک روی دره,Roy Darah clinic,0,1,573,481,1055
8,807,807068,مکتب خواجه عارف,Khwajah Arif School,0,0,83,292,375
8,807,807069,مکتب دوآن خاواک,Do Aabi Khawak School,0,0,95,144,239
8,807,807070,مکتب متوسط تل,Tal Secondary School,0,0,20,155,175
8,807,807071,مکتب چون,Chonni School,0,0,278,0,278
8,807,807072,مکتب ده خاواک,Deh Khawak School,0,0,276,451,727
8,807,807073,مسجد کوهسور,Kohsoor Mosque,0,0,420,241,661
8,807,807074,مدرسه امام ابوحنیفه,Imam Abu Haneefah Madrassah,0,0,290,449,739
8,807,807075,مسجد چمار بالا,Chemar Bala Mosque,0,0,173,155,328
8,807,807076,مسجد جامع قلعه,Qalla Jame Mosque,0,0,209,337,546
8,807,807077,مسجد نو دانگ,Naw Dang Mosque,0,0,181,461,642
8,807,807078,لیسه کوجان,Kojan High School,0,1,405,315,721
8,807,807079,مسجد شال کچه,Shal Kacha Mosque,0,0,317,253,570
8,807,807080,مکتب ابتدائیه شهربلند,Shahr e Billand Primary School,0,0,147,104,251
8,807,807081,مسجد کل کوا,Kul Kawa Mosque,0,0,238,250,488
8,807,807082,لیسه کرپیتاب,Karpeetab High School,0,0,416,433,849
8,807,807083,مکتب ابتدائیه پس مزار,Pas Mazar Primary School,0,0,145,141,286
8,808,808085,مسجد اهل شفیع,Ahl e Shafee Mosque,0,0,273,401,674
8,808,808086,مکتب ذکور آستانه,Astanah Boys School,0,1,287,375,663
8,808,808087,مسجد جامع قولندور,Qulandoor Jame Mosque,0,1,372,540,913
8,808,808088,لیسه ذکور عبدالودود شهید,Abdul Wadoud Shaheed Boys High School,0,0,479,477,956
8,808,808089,مکتب ابتدایه خواجه خض,Khwajah Khezar Primary School,0,0,272,237,509
8,808,808090,مکتب ذکور پرنګان,Parangan Boys School,0,0,109,224,333
8,808,808091,مکتب متوسطه مختلط گلاب خیل,Gulab Khil Secondary School,0,0,453,501,954
8,808,808092,مسجد جامع سنگ خان,Sangi Khan Jame Mosque,0,1,165,225,391
8,808,808094,مکتب مختلط محمد نسیم شهید,Mohammad Nasim Shaheed Boys and Girls School,0,1,217,220,438
8,808,808096,مسجد پائی جوی,Paeen Joi Mosque,0,1,308,243,552
8,808,808097,مسجد ده سیوا,Deh Sewa Mosque,0,0,113,129,242
8,808,808093,مکتب بابا علی,Ba Ba Ali School,0,0,116,77,193
8,808,808095,مکتب جر علی,Jar Ali School,0,1,209,210,420
9,901,901002,چپ دریا مقابل باغ قهوه خانه، مکتب کا,"On the left side of the sea, Opposite the Bagh e *",0,0,1387,ت9ه ا8ت0فا1ق,2476
9,901,901004,مسجد جامع تکیه خانه تپه فرحت,Takya Khanah Farhat Jame Mosque,0,2,2268,2730,5000
9,901,901005,مکتب خواجه کمال ولی,Khwajah e Kamal Wali School,0,4,702,1131,1837
9,901,901006,لیسه پارک شمرق,Shamraq Park High School,0,1,615,910,1526
9,901,901007,مسجد حصرت عثمان غت,Hazrat Usman Ghani Mosque,0,1,2885,3444,6330
9,901,901008,لیسه عمر فاروق,Omer Farouq High School,0,2,1551,5400,6953
9,901,901009,مسجد قول پنجشتی ها,Qul e Punjsheri ha Mosque,0,4,638,1307,1949
9,901,901010,مسجد حاج عبدالغفار,Haji Abdul Ghafar Mosque,0,0,725,1505,2230
9,901,901011,لیسه نسوان حوا,Hawa Girls High School,0,1,1660,2216,3877
9,901,901012,مکتب نمت 2,School no. 2,0,2,1651,2899,4552
9,901,901013,لیسه نسوان معدن,Madan Girls High School,0,10,2378,3062,5450
9,901,901014,لیسه بند دو,Band e du High School,0,1,1268,1711,2980
9,901,901015,مسچد زمان خیل گاوسوار,Zaman Khil Gawsawr Mosque,0,38,962,789,1789
9,901,901016,لیسه حسی خیل,Hussain Khil High School,0,131,350,1021,1502
9,901,901019,مکتب تور شهید,Toor Shaheed School,0,18,459,750,1227
9,901,901022,مکتب سید جمال الدین افغان چشمه ش,"Sayed Jamaluddin Afghan School, Chashma e Sheer, *",0,2,5م1ری,32سر2ک مزار پل,249
9,901,901023,مسجد قریه وزیر آیاد,Wazir Abad village Mosque,0,6,665,1068,1739
9,901,901025,مسجد نیاز الله,Niazullah Mosque,0,8,90,373,471
9,901,901037,کهنه مسجد,Kuhnah Masjid,0,0,0,12,12
9,901,901038,مکتب چشمه شت,Chashma e Sheer School,0,5,7,118,130
9,901,901040,مکتب الجهاد مهاجرین,Aljihad Mahajereen School,0,2,6,105,113
9,901,901041,کمپ خواجه الوان سرک پلخمری مزار,"Khwajah Alwan camp, Pul e Khumri Mazar Shareef Ro*",0,93,28,ی8ف38,509
9,901,901003,مسجد خالد بن ولید,Khalid Bine Walid Mosque,0,3,1107,1780,2890
9,903,903067,لیسه شت جنگل,Shutur Jangal High School,0,1,1047,1027,2075
9,903,903068,مکتب کیان,Kyan School,0,2,1188,585,1775
9,903,903069,لیسه زکورکلان گذر,Kalan Guzar Boys High School,0,0,704,712,1416
9,903,903071,کلینیک چار در,Char Dar Clinic,0,1,687,626,1314
9,903,903072,مسجد قریه زارغه,Zaregha village Mosque,0,0,202,273,475
9,903,903073,لیسه رونق نادری,Raunaq Naderi High School,0,1,588,641,1230
9,903,903074,لیسه کنده سنگ,Kundah Sang High School,0,1,269,428,698
9,903,903075,مکتب دره گ,Darahgai School,0,0,444,403,847
9,903,903076,لیسه نسوان چهل غوری دوش,Chehel Ghori Doshi Girls High School,0,0,711,502,1213
9,903,903077,لیسه حصرت علی دوش,Hazrat Ali Doshi High School,0,32,381,972,1385
9,903,903078,مدرسه جامع خواجه زید,Khwajah Zaid Jame Madrassah,0,1,264,544,809
9,903,903079,مدرسه ابوحنیفه,Abu Haneefah Madrassah,0,3,241,554,798
9,903,903080,نزدیک پل بید دره مکتب دوش,"Doshi School, near Pul e Bed Darah",0,0,218,499,717
9,903,903081,مدرسه جامع قریه کرو,Kuru village Jame Madrassah,0,0,11,157,168
9,903,903082,صالون اجتماعی زرد سنگ,Saloon Ijtemai (Community Hall) Zard Sang,0,1,388,390,779
9,903,903083,مکتب متوسطه سنگ سوراخ,Sang Surakh Secondary School,0,3,562,767,1332
9,903,903085,لیسه کیله گ,Kelah Gai High School,0,2,708,1225,1935
9,903,903086,مکتب لرخواب,LarKhwab School,0,0,1083,1150,2233
9,903,903087,مکتب چهل کپه,Chehel Kapah School,0,20,1146,1130,2296
9,903,903088,داخل قریه خان محمد ناصری,Inside khan Mohammad Naseri village,0,251,1599,1694,3544
9,903,903090,مکتب متوسطه ناصری,Naseri Secondary School,0,0,1160,589,1749
9,903,903070,مکتب تلختان,Talkhtan School,0,0,195,220,415
9,904,904091,مکتب نسوان شهر قدیم,Shahr Qadeem Girls School,0,0,678,1813,2491
9,904,904092,لیسه نسوان ب ب آمنه,Bi Bi Amenah Girls High School,0,0,590,1626,2216
9,904,904093,لیسه گلمتان شهید,Gulmeeran Shaheed High School,0,0,381,742,1123
9,904,904094,مکتب جوی کلان حاج فاضل,Joi Kalan Haji Fazil School,0,2,713,724,1439
9,904,904095,مکتب دواب,Do Aabi School,0,1,663,694,1358
9,904,904096,لیسه خواج خصر,Khwajah Khezar High School,0,2,1729,1729,3460
9,904,904097,مکتب الحاقیه خواجه خصر,Khwajah Khezar Ilhaqia School,0,1,1735,1744,3480
9,904,904098,مکتب بادام دره سالنگ,Badam Darah Salangi School,0,1,1163,1756,2920
9,904,904099,مسجد جامع قریه وتر ج,Watarchi village Jame Mosque,0,1,1744,1167,2912
9,904,904100,مکتب سیاه دره,Syah Darah School,0,10,1177,1602,2789
9,904,904101,مکتب کوتل ستک,Kotal Sabzak School,0,1,1142,1155,2298
9,904,904102,مکتب سجان,Sajan School,0,0,588,1750,2338
9,904,904103,مسجدخالد بن ولید,Khalid Bin e Walid Mosque,0,0,282,564,846
9,904,904104,مکتب شیندره,Shin Darah School,0,0,717,855,1572
9,904,904105,مسجد سرکاتب لعل محمد,Sar Kateb Lal Mohammad Mosque,0,0,385,530,915
9,904,904106,مسجدحافظ بچه,Hafez Bacha Mosque,0,0,450,735,1185
9,904,904107,مکتب الحاقیه مت محمد شهید,Mir Mohammad Shaheed Ilhaqia School,0,1,154,521,676
9,904,904109,مکتب حصرت عثمان,Hazrat Usman School,0,0,221,643,864
9,904,904113,مکتب اره کش,Arah Kash School,0,3,2290,2268,4561
9,904,904114,مدرسه لوزک,Madrasah e Lawzak,0,1,1741,1742,3484
9,904,904117,مکتب قره غاج ساکه,Qarah Ghaj Sakah School,0,900,2166,2217,5283
9,904,904115,مکتب حصرت عباس,Hazrat Abas School,0,1,1185,1741,2927
9,904,904116,مکتب تلی ها,Tali ha School,0,5,1168,1739,2912
9,905,905118,مکتب متوسطه لقها,Luqha Secondary School,0,89,556,1069,1714
9,905,905119,مکتب نسوان بغلان جدید,Baghlan Jadeed Girls School,0,47,1124,1955,3126
9,905,905120,کلوپ شاروالی بغلان جدید,Baghlan Jadeed Municipality Club,0,11,544,1364,1919
9,905,905121,مسجد جامع بغلان مرکزی,Baghlan Markazi Jame Mosque,0,26,0,2755,2781
9,905,905122,صحت عامه بغلان جدید,Baghlan Jadeed Public Health,0,10,835,1489,2334
9,905,905123,مدرسه چیاب,Cheyabi Madrassah,0,0,388,739,1127
9,905,905124,لیسه جمعیت ابو رجا,Abu Reja Jamiat High School,0,3,370,545,918
9,905,905125,مسجدحاج نت,Haji Nabi Mosque,0,7,580,1672,2259
9,905,905126,مسجد جامع شهر بغلان قدیم,Baglan Qadeem city Jame Mosque,0,3,912,1049,1964
9,905,905127,مکتب ریس پاینده جان,Raees Payenda Khan School,0,0,1157,1735,2892
9,905,905128,مکتب زرینه,Zareenah School,0,24,2666,2322,5012
9,905,905129,فابریکه قند لیسه ذکور بغلان صنعت,"Baghlan Sanati Boys High School, near Sugar Mill",0,2,664,1441,2107
9,905,905130,مکتب ناز کمت شهید,Nazukmeer Shaheed School,0,2,123,368,493
9,905,905131,مکتب خواجه خان بابا,Khwajah Khan Baba School,0,687,796,969,2452
9,905,905132,مسجد توراب ها,Toornai ha Mosque,0,22,246,1026,1294
9,905,905133,سرک 11مکتب متوسطه میا گل شهید,"Mia Gul Shaheed Secondary School, Street 11",0,21,348,277,646
9,905,905135,مکتب میاگل شهید,Mia Gul Shaheed School,0,2585,2344,1901,6830
9,905,905136,مسجدخلازب,Khalazai Mosque,0,13,1632,2289,3934
9,905,905137,مکتب شیخ جلال,Shiekh Jalal School,0,23,1767,2877,4667
9,905,905139,مکتب ملا تور,Mullah Toor School,0,71,1108,1038,2217
9,905,905140,مسجد غلام مهی الدین یکه توت,Ghulam Mohiuddin Yaka Toot Mosque,0,12,282,148,442
9,905,905141,کلینیک بشها,Bashar ha Clinic,0,1,468,994,1463
9,905,905142,مکتب لیسه حسن تال,Hasan Tal High School,0,0,1592,2618,4210
9,905,905143,مسجد سفید مکتب ابتداب,Masjid Safid Primary School,0,1,1744,2321,4066
9,905,905144,مکتب متوسطه جلوگت,Jilawgeer Secondary School,0,1,558,1678,2237
9,905,905145,مسجد قریه حاج دلاور,Haji Delawar village Mosque,0,0,531,1043,1574
9,905,905147,مکتب چهاد شنبه تیپه,Chahar Shanbah Tepah School,0,1,488,976,1465
9,905,905150,مکتب ابوحد جرخشک,Abo Muhammad Jarkhushk School,0,128,922,1681,2731
9,905,905156,لیسه ذکور منگل ها,Mangal Ha Boys High School,0,7,2187,2307,4501
9,905,905157,مسجدجامع کهنه قلعه,Kuhna Qalla Jame Mosque,0,0,42,552,594
9,905,905158,مسجد ملاخیل,Mulla Khil Mosque,0,1,275,808,1084
9,905,905159,مکتب غروشاخ,GharoShakh School,0,2,479,1646,2127
9,905,905160,طرف جپ قصرخیل قشلاق عرب ها,"Arab ha village, on the left side of the Qasarkhil",0,3,375,755,1133
9,905,905161,مکتب لیسه قیصرخیل,Qaisarkhil High School,0,0,437,759,1196
9,906,906164,مکتب احمد شاه مسعود,Ahmad Shah Maoud School,0,2,581,264,847
9,906,906165,مکتب لیسه باجگاه,Bajgah High School,0,25,1155,543,1723
9,906,906166,مکتب امرود,Amroud School,0,3,572,741,1316
9,906,906167,مسجد فراق دره,Feraq Darah Mosque,0,13,299,231,543
9,906,906168,لیسه زکور خنجان,Khinjan Boys High School,0,11,1235,1775,3021
9,906,906169,مسجد گزان,Gazan Mosque,0,0,387,884,1271
9,906,906170,مکتب لیسه حارث,Haris High School,0,1,377,685,1063
9,906,906171,مکتب لیسه,High School,0,1,558,553,1112
9,906,906172,مکتب متوسطه للمه ی,Lalma yee Secondary School,0,0,1140,578,1718
9,907,907173,مسجد لغک,Laghak Mosque,0,0,60,154,214
9,907,907174,مسجد دره گ,Darah gai Mosque,0,0,30,228,258
9,907,907175,مسجد جامع سر پل,Sar e Pul Jame Mosque,0,0,50,226,276
9,907,907176,لیسه زکور بنو,Bannu Boys High School,0,1,600,1181,1782
9,907,907177,لسیه نسوان کشن آباد,Kishan Abad Girls High School,0,1,1116,724,1841
9,907,907178,لیسه کفت خانه,Kaftar Khana High School,0,0,582,985,1567
9,907,907180,مسجد سپیچ,Sapeech Mosque,0,1,389,558,948
9,907,907181,لیسه یوچ,Youch High School,0,1,926,1166,2093
9,907,907179,مکتب متوسطه خوش دره,Khosh Darah Secondary School,0,4,1117,912,2033
9,908,908182,مسجد کمیخلر,Kamekhlar Mosque,0,2,1118,2183,3303
9,908,908183,مسجد قریه ارزنگان,Arzangan village Mosque,0,0,146,395,541
9,908,908184,مدرسه سنگتان,Sangbaran Madrassah,0,0,263,474,737
9,908,908185,مکتب بازار ده صلاح,Deh Salah Bazar School,0,17,331,1027,1375
9,908,908186,مسجد سریف ساکه,Shareef Sakah Mosque,0,0,303,458,761
9,908,908187,مکتب لیسه اناس دیزک,Anas Deezak High School,0,0,202,306,508
9,908,908188,لیسه شهید محمد رسول محست,Shaheed Mohammad Rasoul Mohsini High School,0,0,422,758,1180
9,908,908189,مدرسه امام قطیبه,Imam Qutaibah Madrasah,0,0,1118,3418,4536
9,908,908190,مکتب متوسطه درگ,Dargai Secondary School,0,1,526,1053,1580
9,908,908191,لیسه شهشان,Shahshan High School,0,0,577,1059,1636
9,908,908192,مکتب کوتل مرغ,Kotal E Murgh School,0,0,565,1101,1666
9,908,908193,مکتب تل مت غازی,Tal Mir Ghazi School,0,0,569,1104,1673
9,909,909194,مسجد ماسان,Masan Mosque,0,3,1150,1150,2303
9,909,909195,مسجد جامع خواجه اولیا,Khwajah Awlia Jame Mosque,0,1,1743,1730,3474
9,909,909196,لیسه حمید الله شهید,Hameedullah Shaheed High School,0,2,591,2323,2916
9,909,909197,مسجد جامع زرد اسپان,Zard Aspan Jame Mosque,0,0,2346,1744,4090
9,909,909198,لیسه یرم علیا,Yaram Ulya High School,0,1,397,1174,1572
9,909,909199,لیسه مولوی سید احمد,Mawlawi Sayed Ahmad High School,0,0,257,646,903
9,909,909200,مدرسه وریچ,Wareechi Madrassah,0,0,365,717,1082
9,909,909201,مکتب ابتدائیه گدری,Gadari Primary School,0,0,1120,1151,2271
9,909,909202,مکتب غوری سنگ,Ghori Sang School,0,0,106,461,567
9,909,909203,مسجد جامع گدری,Gadari Jame Mosque,0,0,456,618,1074
9,909,909204,مکتب ابتدائیه خواجه هجران,Khwajah Hejran Primary School,0,0,84,697,781
9,910,910205,مکتب شورچه,Shorchah School,0,2,2280,2247,4529
9,910,910206,مکتب سرسر,Shar Shar School,0,1,1772,1801,3574
9,910,910207,مکتب متوسطه سای هزاره,Sai Hazarah Secondary School,0,2,1646,1663,3311
9,910,910208,مکتب فلول علیا,Fulol Ulya School,0,2,1737,2201,3940
9,910,910210,مکتب نو آباد دشت فلول,Nawabad Dasht e Fulol School,0,3,337,537,877
9,910,910211,لیسه نسوان مرکز,Markaz Girls High School,0,2,755,1012,1769
9,910,910212,مکتب چپه,Chappah School,0,0,370,550,920
9,910,910209,لیسه فلول,Fulol High School,0,1,410,664,1075
9,911,911223,مسجد امت نازیه,Amir Naziah Mosque,0,2,1147,1137,2286
9,911,911224,مسجد جامع گردنده,Gardandah Jame Mosque,0,0,1149,654,1803
9,911,911225,مسجد هر دو آب,Har du Aab Mosque,0,0,603,1786,2389
9,911,911226,مسجد افغان قول,Afghan Qul Mosque,0,2,1157,1179,2338
9,911,911227,مسجد سنگ پران,Sang Paran Mosque,0,0,553,547,1100
9,911,911228,مسجد کلوله سنگ,Kololah Sang Mosque,0,1,1146,1176,2323
9,911,911230,مکتب متوسطه خیلر,Khelar Secondary School,0,1,1137,567,1705
9,911,911231,مکتب لیسه وادو,Wadu High School,0,0,0,567,567
9,911,911232,مکتب ترمش,Tarmesh School,0,0,1185,582,1767
9,911,911233,مدرسه بلندی اسرف,Bilandi Ashraf Madrassah,0,0,572,1138,1710
9,911,911234,مکتب متوسطه دهنه استمه,Dahana e Astmah Secondary School,0,0,1708,2248,3956
9,911,911235,مکتب ذکور تاله,Talah Boys High School,0,2,2322,2253,4577
9,911,911236,مکتب متوسطه برفک,Barfak Secondary School,0,1,1049,1698,2748
9,911,911237,مدرسه نعمانیه,Nomania Madrassah,0,1,1695,2337,4033
9,912,912238,مکتب هندوکش,Hindukush School,0,0,1175,1174,2349
9,912,912239,لیسه سراب,Sarab High School,0,1,1156,1676,2833
9,912,912240,مکتب سمندان,Samandan School,0,1,1160,1146,2307
9,912,912241,لیسه ذکور قزه,Qazah Boys High School,0,0,184,295,479
9,912,912242,مسجد لکر مار,Lakar Mar Mosque,0,4,162,461,627
9,912,912243,مکتب سیدآباد,Sayed Abad School,0,0,465,946,1411
9,912,912244,مکتب ده یک,Deh Yak School,0,0,133,587,720
9,912,912245,مکتب اصحاب کهف,Ashab e Kahf School,0,0,181,568,749
9,912,912246,مکتب نوب هار,Nawbahar School,0,0,551,1054,1605
9,912,912247,مکتب متوسط انامک,Anamak Secondary School,0,1,584,1157,1742
9,912,912248,مکتب تغانک,Taghanak School,0,1,1169,1149,2319
9,912,912249,مکتب دریشو,Dreshu School,0,2,1150,1140,2292
9,913,913250,مکتب ابتدائیه خاهوش,Khahosh Primary School,0,0,1708,2299,4007
9,913,913251,مکتب گذر,Guzar School,0,0,1126,1762,2888
9,913,913252,مکتب متوسطه ملم,Malam Secondary School,0,1,1166,1731,2898
9,913,913253,مدرسه ده کلان,Deh Kalam Madrassah,0,1,1114,1113,2228
9,913,913254,مکتب متوسطه عبدالطیف,Abdul Latif Secondary School,0,1,1675,1731,3407
9,913,913255,مکتب محمد افضل شهید,Mohammad Afzal Shaheed School,0,0,130,663,793
9,913,913256,مکتب ابتدائیه اتفاق,Itefaq Primary School,0,1,81,419,501
9,913,913257,مکتب لیسه ستمحمد خان,Sabz Mohammad Khan High School,0,1,504,767,1272
9,913,913258,مکتب زکورخوشدره,Khoshdarah Boys School,0,0,280,771,1051
9,913,913259,مکتب ابتدائیه قلعه مت,Qalla e Mir Primary School,0,81,443,1061,1585
9,913,913260,مکتب متوسطه کنجک,Kunjak Secondary School,0,0,114,385,499
9,913,913261,مکتب گردن تل,Gardan Tal School,0,0,171,558,729
9,913,913262,مکتب نسوان دو اب,Do Aabi Girls School,0,0,497,887,1384
9,913,913263,مکتب گرم آبه,Garam Aabah School,0,0,477,559,1036
9,913,913264,مکتب لیسه میان شهر,Myan Shahr High School,0,0,518,1094,1612
9,913,913265,مکتب ابتداب یخه,Yakha Primary School,0,0,1648,1688,3336
9,913,913266,مکتب متوسطه بهارک,Baharak Secondary School,0,0,70,389,459
9,913,913267,مکتب ابتداب وچ,Wech Primary School,0,1,552,561,1114
9,913,913268,مکتب لیسه بازار,Bazzar High School,0,2,506,1418,1926
9,913,913269,مکتب عبدالحق نارزو,Abdul Haq Narzu School,0,2,519,1714,2235
9,913,913270,مدرسه ده متک,Deh Meerak Madrassah,0,0,1454,1166,2620
9,913,913271,مکتب متوسطه سچ,Sachi Secondary School,0,0,567,548,1115
9,914,914272,مکتب متوسطه جرآب,Jar Aab Secondary School,0,0,205,420,625
9,914,914273,لیسه زکور غارو,Gharu Boys High School,0,0,792,884,1676
9,914,914274,مکتب نسوان محمد حنیف,Mohammad Hanif Girls School,0,1,1699,1605,3305
9,914,914275,مکتب لیسه یاهور,Yahoor High School,0,0,853,642,1495
9,915,915276,مکتب لیسه میهن رامی دهنه فرنگ,Maihan Rameen Dahana e Farang High School,0,1,1070,1129,2200
9,915,915277,مسجد ده مت,Deh Mir Mosque,0,1,530,562,1093
9,915,915278,مسجد حاج محمد علم خان,Haji Mohammad Alam Khan Mosque,0,0,371,377,748
9,915,915279,مسجد مولوی فضل الرحمن,Mawlawi Fazlul Rahman Mosque,0,0,224,206,430
9,915,915280,لیسه مرکزی سوق,Markazi Souq High School,0,0,383,640,1023
9,915,915282,مسجد حصرت صاحب,Hazrat Saheb Mosque,0,3,1135,564,1702
9,915,915283,مسجد دشت شهان,Dasht e Shahan Mosque,0,0,575,568,1143
9,915,915284,مسجد مراد شهر,Murad Shahr Mosque,0,1,558,1149,1708
9,915,915281,مسجد سوق,Souq Mosque,0,0,136,272,408
10,1001,1001001,ریاست تربیه معلم,Directorate of Teacher Training,0,1,1473,1642,3116
10,1001,1001002,مکتب دخیانه سید آباد,Said Abad Girls School,0,1,1413,1819,3233
10,1001,1001003,مسجد لالاخیل,Lala Khil Mosque,0,0,265,238,503
10,1001,1001004,مسجد خاتم النبی,Khatimul Nabeen Mosque,0,0,687,493,1180
10,1001,1001005,مکتب نسوان زرگران,Zargaran Girls School,0,0,1167,691,1858
10,1001,1001006,لیسه نسوان ت بوت,Tee Botee Girls High School,0,0,1604,1363,2967
10,1001,1001007,لیسه ذکور مرکز بامیان,Markaz Bamyan Boys High School,0,0,887,2961,3848
10,1001,1001008,لیسه کارته صلح,Kart e Sulah High School,0,0,1274,1184,2458
10,1001,1001009,مکتب ذکور سرخ دره,Surkh Darah Boys School,0,1,734,600,1335
10,1001,1001010,مسجددهن نیک,Dahan Nek Mosque,0,0,434,399,833
10,1001,1001011,مکتب بام سرای,Bam Sarai School,0,0,1003,917,1920
10,1001,1001012,مدرسه شینیه,Sheneah Madrassah,0,0,1016,861,1877
10,1001,1001013,اتاق شورا دشت تیکر,Dasht Tekar Shura (Council) bilding,0,0,914,792,1706
10,1001,1001014,مکتب نسوان ذکریا,Zekria Girls School,0,0,861,781,1642
10,1001,1001015,مکتب قازان,Qazan School,0,1,745,619,1365
10,1001,1001016,مکتب جوکار دالک,Jawkar Dalak School,0,1,372,341,714
10,1001,1001017,منیچب دره,Menbar Chap Darah,0,0,473,420,893
10,1001,1001018,مکتب دوکات,Dokani School,0,0,332,312,644
10,1001,1001019,مکتب دکدان,Dakdan School,0,0,354,343,697
10,1001,1001020,لیسه حیدرآباد,Haiderabad High School,0,0,772,636,1408
10,1001,1001021,مسجد سوماره,Sumarah Mosque,0,0,316,310,626
10,1001,1001022,مسجد توپچ,Toupchi Mosque,0,0,455,465,920
10,1001,1001023,مکتب آق رباط,Aaq Rubat School,0,0,379,347,726
10,1001,1001024,مکتب باریکی شهیدان,Bareeki Shaheedan School,0,0,192,199,391
10,1001,1001025,مکتب سیاه لا یک,Syah La Yak School,0,0,387,384,771
10,1001,1001026,مسجد نعل شیه,Nal Sheerah Mosque,0,0,717,657,1374
10,1001,1001027,مکتب شهیدان,Shaheedan School,0,0,671,601,1272
10,1001,1001028,مسجد دهن جوپلال,Dahan e Joplal Mosque,0,0,190,195,385
10,1001,1001029,منی جیم قلعه,Menbar Jeem Qalla,0,0,168,149,317
10,1001,1001030,مکتب پیداد شییتو,Peerdad Shebartu School,0,0,424,397,821
10,1001,1001031,مکتب توپ علی,Toup Ali School,0,0,484,421,905
10,1001,1001032,مکتب چهارچشمه,Chahar Chashma School,0,0,233,206,439
10,1002,1002033,مکتب نسوان سرکالو,Sarkalu Girls School,0,0,413,436,849
10,1002,1002034,لیسه دهن دیوالک,Dahan e Diwalak High School,0,0,414,419,833
10,1002,1002035,مسجد سی آب,Sabz Aab Mosque,0,0,169,814,983
10,1002,1002036,مکتب شینیه عراق,Sheneah Iraq School,0,0,367,352,719
10,1002,1002037,مکتب واته پور,Watah Pour School,0,1,199,198,398
10,1002,1002038,مکتب متوسطه جولا,Jola Secondary School,0,1,119,112,232
10,1002,1002039,مکتب نسوان شنبل,Shanbal Girls School,0,0,170,248,418
10,1002,1002040,مکتب ذکور شنبل,Shanbal Boys School,0,0,130,175,305
10,1002,1002041,مکتب نسوان برگلیج,Barglej Girls School,0,0,105,137,242
10,1002,1002042,مسجد جلمش,Jalmash Mosque,0,0,187,186,373
10,1002,1002043,مکتب نسوان دهن غندک,Dahan e Ghundak Girls School,0,0,386,721,1107
10,1002,1002044,مسجد توغ بالا,Toghi Bala Mosque,0,0,147,310,457
10,1002,1002045,مسجد باغک,Baghak Mosque,0,0,442,53,495
10,1002,1002046,مدرسه سری قندی باغک,Sar e Qundi Baghak Madrassah,0,0,292,357,649
10,1002,1002047,مکتب کنگور,Kangoor School,0,0,136,365,501
10,1002,1002048,مسجد جامع سرده,Sar Deh Jame Mosque,0,0,198,271,469
10,1003,1003049,مسجد کوگدای,Kogadai Mosque,0,0,154,96,250
10,1003,1003050,مسجد غراب,Gharab Mosque,0,2,437,489,928
10,1003,1003051,مسجد جو دره,Jawdarah Mosque,0,0,102,103,205
10,1003,1003052,مکتب پیشنگ,Peeshang School,0,0,261,308,569
10,1003,1003054,مسجد ایشانها,Eshan Ha Mosque,0,0,190,157,347
10,1003,1003055,مکتب دخیانه غورچ,Ghorchi Girls School,0,0,398,400,798
10,1003,1003056,مسجد چراغدان,Cheraghdan Mosque,0,0,383,149,532
10,1003,1003057,مسجد بغندی قرغان,Bughundi Qurghan Mosque,0,1,339,256,596
10,1003,1003059,دفی شورای سوخته چنار,Soukhta Chinar Shura (Council) Office,0,0,144,121,265
10,1003,1003060,تعمی شورا قرونه سفلی,Qaroonah Sufla Shura (Council) building,0,0,667,528,1195
10,1003,1003061,مکتب ده ایمان,Deh Iman School,0,0,531,381,912
10,1003,1003062,مسجد خواجه گنج,Khwaja Ganj Mosque,0,0,434,419,853
10,1003,1003063,مسجد پشته واز,Pushtah waz Mosque,0,0,173,154,327
10,1003,1003064,منی عمومی قلعه بیگل,Menbar Umoomi Qalla e Begal,0,0,367,355,722
10,1003,1003065,مسجد قلعچه,Qalacha Mosque,0,0,231,229,460
10,1003,1003053,مسجد جامع بیانقلی, Bayan Quli Jame Mosque,0,0,668,463,1131
10,1003,1003058,لیسه ذکور مرکز خداداد خیل, Markaz Khudadad Khil Boys High School,0,0,775,562,1337
10,1004,1004066,مکتب ذکور دورو,Duru Boys School,0,1,987,830,1818
10,1004,1004067,متوسطه نسوان دوشاخ,Du Shakh Girls Secondary School,0,1,384,424,809
10,1004,1004068,مکتب باجگا,Bajgah School,0,0,135,180,315
10,1004,1004069,لیسه ذکورانداب,Andab Boys High School,0,2,593,534,1129
10,1004,1004070,مکتب دشت سفید,Dasht e Safid School,0,0,1148,991,2139
10,1004,1004071,مسجد دربند,Darband Mosque,0,0,378,343,721
10,1004,1004072,مکتب متوسطه کلیچ,Kaleech Secondary School,0,0,294,552,846
10,1004,1004073,مدرسه دو آب,Du Aab Madrassah,0,1,639,1230,1870
10,1004,1004074,مکتب اشپشته,Ishpeshtah School,0,25,329,284,638
10,1004,1004076,مسجد چوکری دره,Chokri Darah Mosque,0,0,250,327,577
10,1004,1004077,مکتب متوسطه ذکور مدر,Madar Boys Secondary School,0,1,718,583,1302
10,1004,1004078,مکتب لورنج,Lawranj School,0,0,202,142,344
10,1004,1004079,مسجد یلگاه,Yalgah Mosque,0,0,496,393,889
10,1004,1004080,مکتب آجر,Aajer School,0,0,683,578,1261
10,1004,1004081,مکتب بنق,Banq School,0,0,530,458,988
10,1004,1004082,مکتب روی سنگ,Roy Sang School,0,0,740,825,1565
10,1004,1004083,مکتب ابتداییه لغکی,Laghaki Primary School,0,0,582,502,1084
10,1004,1004084,مسجد پایان باغ,Payan Bagh Mosque,0,0,839,716,1555
10,1004,1004075,مسجد جامع سرگلی, Sar Guli Jame Mosque,0,0,273,484,757
10,1005,1005085,لیسه نسوان انده,Andah Girls High School,0,0,349,356,705
10,1005,1005086,مدرسه نیک,Nek Madrassah,0,1,2109,2028,4138
10,1005,1005087,منی نیش,Menbar Neshar,0,0,564,491,1055
10,1005,1005088,مکتب فیوز بهار,Ferozbahar School,0,0,414,393,807
10,1005,1005089,لیسه نسوان سرقل,Sar Qul Girls High School,0,0,443,423,866
10,1005,1005090,مکتب متوسطه سیاه بومک,Syah Bomak Secondary School,0,0,183,149,332
10,1005,1005091,مکتب متوسطه شیدوش,Sherdosh Secondary School,0,0,282,342,624
10,1005,1005092,لیسه پاسرویه,Pasroyah High School,0,0,590,549,1139
10,1005,1005093,مکتب متوسطه شهرستان,Shahrestan Secondary School,0,0,183,170,353
10,1005,1005094,لیسه شهید محمودی,Shaheed Mahmoodi High School,0,0,309,344,653
10,1005,1005095,مکتب متوسطه کیک,Kaparak Secondary School,0,0,204,221,425
10,1005,1005096,منی نوشوره,Menbar Nawshorah,0,0,251,276,527
10,1005,1005097,مکتب دزدان چشمه,Duzdan Chashmah School,0,0,303,341,644
10,1005,1005098,منی کشکک نقش,Menbar Kashkak Naqshi,0,0,112,125,237
10,1005,1005099,منی خورجی بلاق سفلی,Menbar Khorjeen Balaq Sufla,0,0,125,129,254
10,1005,1005100,مکتب متوسطه بغلک,Baghalak Secondary School,0,0,158,137,295
10,1005,1005101,منی بالاحصار گزک,Menbar Bala Hesar Gazak,0,0,465,390,855
10,1005,1005102,مکتب داگاه,Dagah School,0,0,410,375,785
10,1005,1005104,مکتب سر ترنوک,Sar TarNook School,0,0,426,401,827
10,1005,1005105,مکتب تنکی سفیدک,Tangi Safedak School,0,0,454,558,1012
10,1005,1005106,منیسرخک پایی,Menbar Surkhak Payeen,0,0,100,127,227
10,1005,1005107,مکتب متوسطه نسوان سیادره علیا,Syah Darah Ulya Girls Secondary School,0,0,204,214,418
10,1005,1005108,منی شینیه,Menbar Sheneah,0,0,320,327,647
10,1005,1005109,مکتب متوسطه بکک,Bakak Secondary School,0,1,197,176,374
10,1005,1005110,منی سر کنک,Menbar e Sarkanak,0,0,239,265,504
10,1005,1005111,مکتب ده سرخ,Deh Surkh School,0,0,1380,935,2315
10,1005,1005112,لیسه ذکور زارین,Zareen Boys High School,0,0,636,616,1252
10,1005,1005113,مکتب دخیانه بغلک رستم,Baghalak Rustam Girls School,0,0,540,487,1027
10,1005,1005103,مکتب دشت سفلی نیطاق (لیسه زکور), Dasht e Sufla Naitaq Boys School,0,0,717,636,1353
10,1006,1006114,مدرسه علمیه کاظمیه,Ilmiah Kazimiah Madrassah,0,1,196,221,418
10,1006,1006115,مدرسه امام کاظم,Imam Kazim Madrassah,0,6,456,462,924
10,1006,1006116,مدرسه خاتم الانبیا,Khatimul Anbya Madrassah,0,1,261,273,535
10,1006,1006117,لیسه ذکور سرای زرد سنگ,Sarai Zard Sang Boys High School,0,0,230,303,533
10,1006,1006118,مسجد سجادیه,Sejadiah Mosque,0,0,142,101,243
10,1006,1006119,مکتب متوسطه دو آت,Du Aabi Secondary School,0,0,261,253,514
10,1006,1006120,منی شینیه تراپس,Menbar Sheneah Trapis,0,0,198,182,380
10,1006,1006121,مسجد میان قول,Myan Qul Mosque,0,0,127,130,257
10,1006,1006122,مسجد سرخک,Surkhak Mosque,0,0,391,377,768
10,1006,1006123,منی قلعه آخوند,Menbar e Qalla e Akhund,0,0,243,221,464
10,1006,1006124,مکتب متوسطه زیره گک,Zeerahgak Secondary School,0,0,271,260,531
10,1006,1006125,مکتب دخیانه پشت تیلگراف,Pusht e Telegraph Girls School,0,1,812,929,1742
10,1006,1006126,مکتب نسوان پایبوم,Paybom Girls School,0,0,374,368,742
10,1006,1006127,مسجد گرد ت,Gardani Mosque,0,1,368,360,729
10,1006,1006128,منی سفیدجوی,Menbar Safid Joi,0,0,206,224,430
10,1006,1006129,مکتب متوسطه قلعه عاشور,Qalla e Ashor Secondary School,0,0,481,0,481
10,1006,1006130,مکتب نسوان دهن غوچ نو,Dahan e Ghouch Naw Girls School,0,0,327,291,618
10,1006,1006131,مکتب ابتداییه دهن بلاق,Dahan e Bulaq Primary School,0,0,125,132,257
10,1006,1006132,مکتب بارغو سنگ,Bar Ghusang School,0,0,238,205,443
10,1006,1006133,مسجد شینیه گنداب,Sheneah Gandaab Mosque,0,0,134,126,260
10,1006,1006134,مسجد دهن قلعچه,Dahan e Qalacha Mosque,0,0,198,179,377
10,1006,1006135,مدرسه دین دهن کوهدر,Dahan e Kohdar Religious Madrassah,0,0,213,260,473
10,1006,1006136,مکتب شینیه اخضات,Sheneah Akhzarat School,0,0,299,259,558
10,1006,1006137,منی قورغان,Menbar Qurghan,0,1,171,159,331
10,1006,1006138,مکتب نسوان لشکر راه اخضاب,Lashkar Rah Akhzarab Girls School,0,0,263,227,490
10,1006,1006139,مسجد نو دراز کرمان,Masjid I Naw Daraz Kerman Mosque,0,1,215,209,425
10,1006,1006140,مکتب متوسطه پام الیغان,Pamul Targhan Secondary School,0,0,157,164,321
10,1006,1006141,لیسه مختلط سرخ بوم کرمان,Surkh Boom Kerman Boys and Girls High School,0,0,210,212,422
10,1006,1006142,لیسه مختلط شهید نعمت الله,Shaheed Nematullah Boys and Girls High School,0,0,200,191,391
10,1006,1006143,مکتب جامع خارقول,Kharqul Jame School,0,0,302,300,602
10,1006,1006144,مدرسه دهن طاهر,Dahan Tahir Madrassah,0,0,147,154,301
10,1006,1006145,لیسه سگذیز,Sagzeez High School,0,0,263,253,516
10,1006,1006146,لیسه میانکاوک,Myankawak High School,0,0,227,220,447
10,1006,1006147,مکتب متوسطه پیازان,Pyazan Secondary School,0,0,106,129,235
10,1007,1007148,مکتب متوسطه جیان,Jeeran Secondary School,0,0,143,124,267
10,1007,1007149,مکتب اوچه سنگنگ لیگان,Owcha Sangang Leegan School,0,0,167,143,310
10,1007,1007150,مکتب صدمن لیگان,Sadmani Legan School,0,0,467,352,819
10,1007,1007151,مسجد توبک زیر کوه پجندور,Tobak Zer Koh e Puchandoor Mosque,0,0,129,137,266
10,1007,1007152,مسجد نو میلک شینیه پچندور,Nawmeelak Sheneah Pachandoor Mosque,0,0,494,383,877
10,1007,1007153,منی تسور,Menbar Tasour,0,0,159,117,276
10,1007,1007154,مسجد پیتاب کندوک,Peetab Kandook Mosque,0,0,230,3,233
10,1007,1007155,مسجد ورزنگ,Warzang Mosque,0,0,192,190,382
10,1007,1007156,مسجد دیوان,Deewan Mosque,0,0,321,236,557
10,1007,1007157,مسجد غورزیلو,Ghorzeelo Mosque,0,0,420,373,793
10,1007,1007158,مسجد خیمه کلان زمی,Khaimah Kalan Zameen Mosque,0,0,138,133,271
10,1007,1007159,مسجد گنبتک,Gunbatak Mosque,0,0,116,128,244
10,1007,1007160,مسجد گرد بید تگاب گالقول,Masjid Gerd Bed Tagab Galqul Mosque,0,0,284,249,533
10,1007,1007161,مسجد چوب تمان,Chob Taman Mosque,0,0,229,214,443
10,1007,1007162,مکتب سیلیده,Selburdah School,0,0,141,128,269
10,1007,1007163,مسجد سیب باریک,Seb Bareek Mosque,0,0,460,422,882
10,1007,1007164,مسجد خاکشکه,Khakshkah Mosque,0,0,177,154,331
10,1007,1007165,مسجد دهن منگوس شینیه اوبه,Dahan Mangos Sheneah Obah Mosque,0,0,221,184,405
10,1007,1007166,مکتب لیسه ذکور جوقول,Joqul Boys High School,0,1,598,499,1098
10,1007,1007167,مسجد دیرندر,Deerandar Mosque,0,0,234,238,472
10,1007,1007168,مسجد شینیه بستوک,Sheneah Bastouk Mosque,0,0,244,228,472
10,1007,1007169,مسجد دره غول سیاه,Darah Ghoul Syah Mosque,0,0,181,167,348
10,1007,1007170,مسجد رزک,Razak Mosque,0,0,244,198,442
10,1007,1007171,مکتب وار زاغ,Warzagh School,0,0,592,524,1116
10,1007,1007172,مسجد واز درغان,Waz Darghan Mosque,0,0,126,124,250
10,1007,1007173,مکتب متوسطه بند حیدرک,Band e Haidarak Secondary School,0,0,200,212,412
10,1007,1007174,مسجد تخته ها,Takhta ha Mosque,0,0,126,122,248
10,1007,1007175,مکتب سنگ سوراخ,Sang Surakh School,0,0,164,179,343
10,1007,1007176,مسجد توپ اسمعیل,Toup Ismael Mosque,0,0,162,172,334
10,1007,1007177,مکتب متوسطه پلان,Pulan Secondary School,0,0,78,84,162
10,1007,1007178,لیسه سلطان رباط,Sultan Rubat High School,0,0,223,238,461
10,1007,1007179,مکتب ابتدائیه فاطو,Fato Primary School,0,0,130,122,252
10,1007,1007180,لیسه سیب جوی باز گیک,Seb Joi Bazgeerak High School,0,1,263,289,553
10,1007,1007181,لیسه مختلط سرخ کوک,Surkh Kook High School,0,0,184,210,394
10,1007,1007182,مکتب شهرنو,Shahr e Naw School,0,1,408,389,798
10,1007,1007183,مسجد مرکزی ورس,Waras central Mosque,0,0,271,349,620
10,1007,1007184,لیسه دوله و قوم میزا,Dola and Qawm Mirza High School,0,0,169,202,371
10,1007,1007185,مسجد پیش ده,Pesh Deh Mosque,0,0,189,195,384
10,1007,1007186,مدرسه باقریه سرسرآب,Sar Sar Aab Baqeria Madrassah,0,0,304,286,590
10,1007,1007187,مکتب متوسطه نیک پای,NekPai Secondary School,0,0,195,190,385
10,1007,1007188,مسجد شینیه قوم برف,Sheneah Qawm Barfi Mosque,0,0,272,216,488
10,1007,1007189,لیسه عالی چیجی,Chejeen High School,0,0,525,542,1067
10,1007,1007190,مسجد خرابه قول,Kharabah Qul Mosque,0,0,191,183,374
10,1007,1007191,مسجد قلعه سوخته,Qalla e Soukhtah Mosque,0,1,325,280,606
10,1007,1007192,مکتب ابتدائیه سی جوی,Sabz Joi Primary School,0,0,243,248,491
10,1007,1007193,لیسه عالی شینیه تخت,Sheneah Takht High School,0,0,391,386,777
10,1007,1007194,مکتب متوسطه دهن دیوالک,Dahan Dewalak Secondary School,0,0,245,196,441
10,1007,1007195,مکتب میان ملک دهن سرخ کنگگ,Myan Malik Dahan Surkh Kungak School,0,0,284,234,518
10,1007,1007196,مکتب ایستک و اردوخاک,Aestak wa UrduKhak School,0,0,206,161,367
10,1007,1007197,لیسه ذکور بند کوسه,Band Kosah Boys High School,0,0,545,509,1054
10,1007,1007198,مسجد شینیه تنکی سن,Sheneah Tangi Sepi Mosque,0,0,246,241,487
10,1007,1007199,مسجد ریگجوی قوناق,Regjoi Qunaq Mosque,0,0,342,264,606
10,1007,1007200,مکتب متوسطه قول مسوت,Qul Masout Secondary School,0,1,262,268,531
10,1007,1007201,مسجد تنکی زردگ,Tangi Zardak Mosque,0,1,128,98,227
10,1007,1007202,لیسه ذکور قره غجور,Qarah Ghajour Boys High School,0,0,272,181,453
10,1007,1007203,مسجد ایلجم (امام جعفر صادق),Iljam (Imam Jafar Sadeq) Mosque,0,1,229,178,408
10,1007,1007204,لیسه ذکور قلبتو,Qulbatu Boys High School,0,0,647,533,1180
10,1008,1008205,لیسه نسوان سی دره,Sabz Darah Girls High School,0,0,793,763,1556
10,1008,1008206,لیسه نسوان کلیگان,Kaligan Girls High School,0,0,261,274,535
10,1008,1008207,لیسه سچک,Sachak High School,0,0,672,637,1309
10,1008,1008208,منی خمیه سیاه خاک,Menbar Khaimah Syah Khak,0,0,469,517,986
10,1008,1008209,مکتب غرغرک سرذولیج,Ghar Gharak Sarzawlej School,0,0,222,259,481
10,1008,1008210,منی شینیه سرذولیج,Menbar Sheneah Sarzawlej,0,0,154,159,313
10,1008,1008211,لیسه نسوان سوختکی دره چاشت,Sokhtagi Darah e Chasht Girls High School,0,0,461,380,841
10,1008,1008212,منی ایلبوبک,Menbar Elbobak,0,0,240,242,482
10,1008,1008213,منی پای وچه,Menbar Pai wocha,0,0,212,232,444
10,1008,1008214,مکتب نسوان قلعه غشار,Qalla e Gheshar Girls School,0,0,147,178,325
10,1008,1008215,مکتب نسوان دره مزار,Darah e Mazar Girls School,0,0,898,0,898
10,1008,1008216,منی زیردخمه,Menbar Zer Dakhmag,0,0,466,471,937
10,1008,1008217,منی پایی دوآت شاه قدم,Menbar Payeen Du Aabi Shah Qadam,0,0,386,329,715
10,1008,1008218,منی دهن مرغ,Menbar Dahan Murghi,0,2,326,260,588
10,1008,1008219,مکتب دره چاشت,Darah e Chasht School,0,0,652,574,1226
10,1008,1008220,منیشینیه سر مرغ,Menbar Sheneah Sar Murghi,0,0,460,470,930
12,1201,1201001,سرن روغتون,Sharan Hospital,0,75,0,1645,1720
12,1201,1201002,عل بابا لیسه,Ali Baba High School,0,227,25,3927,4179
12,1201,1201003,محمد خیل عل لیسه نوی نوم,Mohammad Khil High School (New name),0,115,115,1982,2212
12,1201,1201004,زوړ ښوونځ کوتوال,Old Kotwal School,0,115,127,1391,1633
12,1201,1201005,د حضت بلال لیسه,Hazrat Bilal High School,0,76,66,1005,1147
12,1201,1201006,درفیق ښوونځ,Rafiq School,0,18,210,408,636
12,1201,1201007,جومات سپوان,Spwanai Mosque,0,3,12,466,481
12,1201,1201008,د ن ن زینب ښوونځ,Bi Bi Zainab School,0,66,161,861,1088
12,1201,1201009,عسی بابا ښوونځ,Eisa Ba Ba School,0,211,6,218,435
12,1201,1201010,جومات بنوس قلعه,Banosai Qalla Mosque,0,7,43,562,612
12,1201,1201011,الجهاد لومړن ښوونځ,Al Jihad Primary School,0,20,87,1363,1470
12,1201,1201012,بدریه ښوونځ,Badria School,0,3,5,280,288
12,1201,1201013,جیت ښوونځ,Jeenai School,0,22,45,389,456
12,1201,1201014,لومړن ښوونځ,Primary School,0,62,12,1352,1426
12,1201,1201015,څل ابراهیم زو ښوونځ,Salai Ibahimzo School,0,21,6,528,555
12,1201,1201016,محمد عل جلالی ښوونځ,Mohammad Ali Jalali School,0,570,56,323,949
12,1202,1202017,مرکز ولسوالی چینه باغ,Cheenah Bagh District Center,0,94,692,1022,1808
12,1202,1202018,چامړی ښوونځ,Chamrrai School,0,2,700,691,1393
12,1202,1202019,ليسه مټا خان,Mata Khan High School,0,33,697,1198,1928
12,1202,1202020,نوی نوم قلعه سیدو لیسه ده,Qalla Saidu High School (New name),0,107,492,918,1517
12,1202,1202022,لغړو لیسه,Lagahro High School,0,45,204,1621,1870
12,1202,1202023,جومات مریان,Maryanni Mosque,0,3,290,912,1205
12,1202,1202024,شورکځ جومات,Shorkachi Mosque,0,34,231,456,721
12,1202,1202025,مکتب کون خیل,Koti Khil School,0,3,576,863,1442
12,1202,1202026,ابراهیمزی جومات,Ibrahimzai Mosque,0,0,364,399,763
12,1202,1202021,فولادخیل عالی لیسه, Folad Khil High School,0,4,213,1003,1220
12,1203,1203027,باران مسجد,Baran Mosque,0,91,146,486,723
12,1203,1203028,عبدالله بابا شوونځ,Aryana School,0,29,0,901,930
12,1203,1203029,خوشحال بابا لیسه,Khoshal Ba Ba High School,0,67,236,1076,1379
12,1203,1203030,یوسف خیل مرکزي لیسه,Yousuf Khil Central High School,0,14,132,1401,1547
12,1203,1203031,اریانا ښوونځ,Abdullah Baba School,0,19,212,738,969
12,1203,1203032,د برات خیل د اناثو ښوونځ,Barat Khil Girls School,0,0,187,692,879
12,1203,1203033,سیدو خیلو جومات,Saidu Khil Mosque,0,12,157,327,496
12,1203,1203034,د میست بازار ښوونځ,Mest Bazar School,0,52,870,1702,2624
12,1204,1204035,مسجد نور محمد,Noor Mohammad Mosque,0,2,84,1308,1394
12,1204,1204036,یځ حیل مرکزی لیسه,Yahya Khil High School,0,4,73,548,625
12,1204,1204037,وحدت ابتدایه ښوونځ,Wahdat Primary School,0,32,229,1185,1446
12,1204,1204038,ښوونځ قرب الدین,Qurbuddin School,0,21,565,1618,2204
12,1204,1204039,نظام الدین متوسطه ښوونځ,Nizamuddin Secondary School,0,4,41,1102,1147
12,1204,1204040,د غیب خیلو لیسه,Ghaeb Khilo High School,0,7,95,1474,1576
12,1204,1204041,د زانکو مسجد,Zanku Mosque,0,9,261,1623,1893
12,1204,1204042,اتلانو ابتدایه ښوونځ,Atalano Primary School,0,55,822,1548,2425
12,1204,1204043,د شهید شامحمود متوسطه,Shaheed Shah Mahmoud Secondary School,0,116,503,1291,1910
12,1205,1205046,ګلرالدین مکتب,Galaruddin School,0,395,92,185,672
12,1205,1205047,عید ګاه جومات,Eidgah Mosque,0,15,198,1701,1914
12,1205,1205050,سروضه لومړن ښوونځ,Sar Rawzah Primary School,0,0,114,597,711
12,1205,1205051,ولسوالی مقام دوهم تعمب,"District Administrator Office, Second building",0,0,4,10,14
12,1205,1205052,لیسه سلطان,Sultani High School,0,2,211,943,1156
12,1205,1205053,ښوونځ پړاو,Parraw School,0,1,575,581,1157
12,1206,1206055,زواکه عالی لیسه,Zwakah High School,0,0,152,349,501
12,1206,1206056,ګیناوه ابتدان ښونځ,Genawah Primary School,0,55,236,483,774
12,1207,1207060,شاه ګل کلا ابتدائیه ښوونځ,"Shah Gul Kala, Preliminary School",0,29,235,1716,1980
12,1207,1207061,مل زی جومات,Mili Zai Mosque,0,23,521,1689,2233
12,1207,1207062,حست لیسه,Hasani High School,0,28,272,1678,1978
12,1207,1207063,ن ن فاطمه ښوونځ,Bi Bi Fatima School,0,132,30,1011,1173
12,1207,1207064,ن ن عائشه ښوونځ,Bi Bi Ayesh School,0,1,0,549,550
12,1207,1207065,سعاداتو جومات,Sadatu Mosque,0,1,334,1675,2010
12,1207,1207066,حاج پاچا جومات,Haji Pacha Mosque,0,64,189,1626,1879
12,1207,1207067,هاشمیه لیسه,Hashimiah High School,0,40,213,1704,1957
12,1207,1207068,پاینده خیل کل ښوونځ,Payenda Khil Village School,0,15,315,1705,2035
12,1207,1207069,حاج ګل بران جومات,Haji Gul Baran Mosque,0,75,565,1089,1729
12,1207,1207070,کیول بابا ښوونځ,Kewol Ba Ba School,0,37,327,1429,1793
12,1207,1207071,س ګانه ابتدائيه ښوونځ,SeGanah Preliminary School,0,7,499,1113,1619
12,1207,1207072,شهیدعبدالحکیم خان ښوونځ,Shaheed Abdul Hakim Khan School,0,47,9,1086,1142
12,1207,1207073,ن ن زهرا لیسه,Bi Bi Zahra High School,0,35,187,1118,1340
12,1207,1207074,بازار روغتون,Bazar Hospital,0,114,26,1456,1596
12,1208,1208085,مچ فقب مسجد,Mach Faqeer Mosque,0,4,1166,1737,2907
12,1208,1208086,منځت ښوونځ شكی,Shakeen Secondary School,0,0,590,875,1465
12,1208,1208087,بازار جومات شکی,Shakeen Bazar Mosque,0,20,526,1075,1621
12,1208,1208088,سورډاګ,Soor Daag,0,2,665,883,1550
12,1208,1208089,ابتدائيه ښوونځ شكی,Shakeen Primary School,0,1,574,766,1341
12,1208,1208094,سعید خیل جومات,Sayed Khil Mosque,0,56,580,1720,2356
12,1208,1208097,عیسی ج ښوونځ,Eisa Jee School,0,3,0,1529,1532
12,1208,1208101,ملاح دولت مدرسه,Mullah Dawlat Madrassah,0,1,0,1378,1379
12,1209,1209104,ښوونځ شاه خیل آباد,Shah Khil Abad School,0,152,0,1707,1859
12,1209,1209105,ذکور نوران ابتدایه مکتب,Noorani Boys Primary School,0,148,314,589,1051
12,1209,1209106,مسجد ګلداد,Guldad Mosque,0,295,95,490,880
12,1209,1209107,د چمبانو د انجونو ابتدایه ښوونځ,Chambaran Girls Primary School,0,1,48,544,593
12,1209,1209108,ابتدایه شهیدعبدالرحمن شوونزی,Shaheed Abdul Rahman Primary School,0,0,26,399,425
12,1209,1209109,جان خیل ښوونځ,Jani Khil School,0,307,91,410,808
12,1209,1209110,جلوزو نجونو ښوونځ,Jalozo Girls School,0,2,731,1733,2466
12,1209,1209111,شاتورو ابتدایه مکتب,Shahturo Primary School,0,389,952,2083,3424
12,1209,1209112,دهست اتحادمتوسطه,Hasthi Itehad Secondary School,0,122,76,334,532
12,1209,1209113,هست ابتدایه,Hasthi Primary School,0,1056,143,1177,2376
12,1210,1210114,ریاض العلوم دوم متوسطه ښوونځ,Reyazul Uloom Secondary School no.2,0,0,239,913,1152
12,1210,1210115,ابتدائيه ښوونځ ربات اضعر كلا,Rubat Asghar Kala Primary School,0,0,574,557,1131
12,1210,1210116,احمدیه متوسطه ښوونځ,Ahmadya Secondary School,0,0,565,566,1131
12,1210,1210117,محمد امی جومات,Mohammad Amin Mosque,0,0,533,1094,1627
12,1210,1210118,مرکزی لیسه,Markazi High School,0,0,177,937,1114
12,1210,1210119,ریاض العلوم اول ابتدایه ښوونځ,Reyazul Uloom Primary School no. 1,0,1,205,895,1101
12,1210,1210120,طاوسخیلو جومات,Tawoos Khil Mosque,0,34,509,1316,1859
12,1210,1210121,عباس خیل ښوونځ,Abas Khil School,0,1,103,1241,1345
12,1210,1210122,زام متوسطه ښوونځ,Zami Secondary School,0,0,586,574,1160
12,1210,1210123,نوی قلعه لیسه,Nawai Qalla High School,0,17,381,1465,1863
12,1210,1210124,زړه قلعه لیسه,Zarra Qalla High School,0,1,185,1126,1312
12,1210,1210126,خان قلعه لېسه,Khani Qalla High School,0,2,360,339,701
12,1211,1211128,شيخان دانجونو ابتداښونځ,Shiekhan Girls Primary School,0,25,439,779,1243
12,1211,1211135,پشت جومات,Pushte Mosque,0,1,167,745,913
12,1211,1211138,چیناخوا مدرسه,Chena Khwa Madrassah,0,0,243,436,679
12,1211,1211139,فقبان کل جومات,Faqeeran village Mosque,0,1,69,924,994
12,1211,1211140,مبا گل جومات,Meera Gul Mosque,0,0,4,200,204
12,1211,1211141,سرحدی ځدراڼ کل ښوونځ,Sarhadi Zadran village School,0,0,528,808,1336
12,1211,1211142,د دهت منځت ښوونځ,Dahane Secondary School,0,0,17,507,524
12,1211,1211143,برکت نجونو ښوونځ,Barakat Girls School,0,0,139,315,454
12,1211,1211144,بالش انجون ابتدان ښوونځ,Balesh Girls Primary School,0,7,614,967,1588
12,1211,1211145,بالش ښوونځ,Balesh School,0,16,230,1068,1314
12,1211,1211146,دګلک دکل جومات,Gulaki village Mosque,0,1,347,961,1309
12,1211,1211147,ارګون زوړ ښوونځ قرخیل,Urgoon old School Qarkhil,0,0,205,499,704
12,1211,1211148,د چمبانو جماعت,Chambarano Mosque,0,0,245,761,1006
12,1211,1211149,زوړ ارګون نجونو ښوونځ,Urgoon old Girls School,0,0,280,917,1197
12,1211,1211150,کلندر مدرسه,Kalandar Madrassah,0,1,118,491,610
12,1211,1211151,غوچ ښوونځ,Ghoch School,0,18,1009,1076,2103
12,1211,1211152,باباصاحب شیخان ښوونځ,Ba Ba Sahib Shiekhan School,0,20,162,221,403
12,1211,1211153,ملکانو منځت ښوونځ,Malakano Secondary School,0,22,578,1050,1650
12,1211,1211154,نورلی ښوونځ,Noorli School,0,0,252,542,794
12,1212,1212155,د ورژانه ضیاءالعلوم لیسه,Warzhana Ziaul Uloom High School,0,0,325,1592,1917
12,1212,1212156,جمیل حان جومات,Jameel Khan Mosque,0,3,572,1107,1682
12,1212,1212157,کلینیک,Clinic,0,3,153,1236,1392
12,1212,1212158,عالمی کل مدرسه,Alimi Village Madrassah,0,0,152,1240,1392
12,1212,1212159,گلستان کلینیک,Gulistan Clinic,0,2,140,1229,1371
12,1212,1212160,بوستان کلینیک,Bostan Clinic,0,0,594,1135,1729
12,1213,1213163,والسوالی مرکز,District Center,0,1,142,291,434
12,1213,1213164,حکیم خان میلمستون,Hakim Khan Melmastoon (Guest House),0,2,586,2084,2672
12,1213,1213165,غازی خان جومات,Ghazi Khan Mosque,0,0,135,799,934
12,1213,1213166,حاج سځ جان میلمستون,Haji Sakhi Jan Melmastoon (Guest House),0,1,560,2049,2610
12,1214,1214169,پیتوګ منځت ښوونځ,Petugai Secondary School,0,0,116,546,662
12,1214,1214170,لوارګ ابتدان مکتب,Lowargai Primary School,0,0,150,918,1068
12,1214,1214171,فخری افغان مکتب,Fakhr e Afghan School,0,0,0,980,980
12,1214,1214172,مسجد خاندان,Khandan Mosque,0,0,0,429,429
12,1214,1214173,ښوونځ نور آباد,Noorabad School,0,3,21,907,931
12,1214,1214174,ش باز میلمستون,Sher Baz Melmastoon (Guest House),0,0,33,1012,1045
12,1214,1214175,فاروقیه ښوونځ,Farouqia School,0,0,0,1039,1039
12,1214,1214178,محمودیه مدرسه,Mahmoudia Madrassah,0,0,0,1091,1091
12,1214,1214179,د ولسوالی جومات,District Mosque,0,1,1,1292,1294
12,1214,1214183,مسجد باډر احمدزی,Border Ahmadzai Mosque,0,0,91,586,677
12,1216,1216208,مرکز ولسوالی خیمه,District Center tent,0,660,35,1244,1939
12,1216,1216209,روغتیان کلینیک,Health Clinic,0,1,584,1715,2300
12,1216,1216210,اکبجان دکان,Akbar Jan Shop,0,1,46,1173,1220
12,1217,1217211,اپسر کوت جومات,Apsar Kot Mosque,0,37,136,1141,1314
12,1217,1217212,حاج آدم کلا جومات,Haji Adam Kala Mosque,0,16,42,309,367
12,1217,1217213,د ولسوالی مركز ابتدائيه ښوونځ,Khezar Khil center School,0,0,2,899,901
12,1217,1217214,خضخیل مرکزی ښوونځ,District Center Primary School,0,0,17,835,852
12,1217,1217215,گلالت جومات,Gulalbi Mosque,0,0,0,230,230
12,1217,1217216,حاج محمد نعیم جومات,Haji Mohammad Naeem Mosque,0,1,15,2058,2074
12,1217,1217217,مرجان جومات,Marjan Mosque,0,317,0,2036,2353
12,1217,1217218,نوران لیسه,Noorani High School,0,30,5,1716,1751
12,1218,1218219,دكل جومات دوچينه,Du Cheenah village Mosque,0,12,24,159,195
12,1218,1218220,د پولیسو پخوان دفب,Police Old Office,0,99,97,247,443
12,1218,1218221,د دو چیت د کل دوکان,Du Cheenah village Shop,0,16,133,101,250
12,1218,1218222,عید گل میلمستون,Eid Gul Melmastoon (Guest House),0,292,282,678,1252
12,1218,1218223,حاج بلول میلمستون,Haji Bahlol Melmastoon (Guest House),0,239,281,741,1261
12,1218,1218224,ښوونځ وکیل غمی,Wakeel Ghamai School,0,14,0,153,167
12,1218,1218225,کلینیک,Clinic,0,7,65,232,304
12,1218,1218226,ولسوالی مرکز,District Center,0,3,11,218,232
12,1218,1218227,مركز ولسوالی متوسطه ښوونځ,District Center Secondary School,0,9,43,135,187
12,1218,1218228,جومات سروزی,Sarozai Mosque,0,7,56,232,295
12,1218,1218229,میلمستون حاج نواب خان,Haji Nawab Khan Melmastoon (Guest House),0,42,136,830,1008
12,1218,1218230,عبدل میلمستون,Abdul Melmastoon (Guest House),0,106,230,950,1286
12,1219,1219231,ولسوالی مرکز توری ښوونځ,DistriCT Center Toori School,0,471,117,110,698
12,1219,1219232,سرور خان چینه جومات,Sarwar Khan Cheenah Mosque,0,545,23,614,1182
12,1219,1219233,کوڅکه جومات,Kochka Mosque,0,81,4,502,587
12,1219,1219234,آمرخیل کاریز جومات,Amarkhil Karez Mosque,0,86,148,1043,1277
12,1219,1219235,بوزه جومات,Bozah Mosque,0,24,0,1112,1136
12,1219,1219236,سدوزائ جومات,Saduzai Mosque,0,322,304,1107,1733
12,1219,1219237,پشکی جومات,Peshaki Mosque,0,267,12,309,588
13,1301,1301001,تیی باغ شاه عالی لیسه,Terai Bagh Shah High School,0,134,169,641,944
13,1301,1301002,عبدالځ عالی لیسه,Abdul Hai High School,0,342,785,6384,7511
13,1301,1301003,لیسه عالی سیدحسن,Sayed Hasan High School,0,10,1580,2313,3903
13,1301,1301004,ششگر عالی لیسه,Shashgar High School,0,178,486,931,1595
13,1301,1301005,پکتیا پوهنتون,Paktia University,0,235,826,2730,3791
13,1301,1301006,مکتب ذکور رباط,Rubat Boys School,0,36,1124,970,2130
13,1301,1301007,لیسه عالی بابا صادق,Ba Ba Sadeq High School,0,1,559,343,903
13,1301,1301008,ابراهیم خیل مکتب,Ibrahim Khil School,0,0,25,102,127
13,1301,1301010,خدایداد خیلو لیسه,Dawlatzai High School,0,256,1120,1408,2784
13,1301,1301011,داد گل جومات,Dadgul Mosque,0,170,603,3769,4542
13,1301,1301012,د بنوزی لیسه,Banozai High School,0,32,478,217,727
13,1301,1301013,لیسه عالی دره,Darah High School,0,113,0,468,581
13,1301,1301014,د زاهو ابتدائیه مکتب,Zaho Primary School,0,0,1048,993,2041
13,1301,1301016,مکتب بالا ده,Bala Deh School,0,3,724,957,1684
13,1301,1301017,د نظر گل جومات,Nazar Gul Mosque,0,6,0,687,693
13,1301,1301018,زربن جومات,Zarbati Mosque,0,69,243,545,857
13,1301,1301019,لیسه عبداله خیل,Abdullah Khil High School,0,61,825,1812,2698
13,1301,1301020,مکتب تیه,Teerah School,0,58,1436,2208,3702
13,1301,1301021,دڅیي مكتب,Serrai School,0,0,508,259,767
13,1301,1301022,د ټنډانو مكتب,Tandano School,0,49,61,295,405
13,1301,1301198,لیسه ده باش,Deh Bashi High School,0,30,561,901,1492
13,1301,1301199,لیسه شاه قمی,Shah Qambar High School,0,50,1527,3121,4698
13,1301,1301015,لیسه خواجه علی مهلن, Khwaja Ali Mahlan High School,0,44,572,816,1432
13,1302,1302024,خواجه خیل مسجد,Khwaja Khil Mosque,0,4,351,321,676
13,1302,1302025,مسجد حاج دلیل,Haji Daleel Mosque,0,2,363,506,871
13,1302,1302026,د رود لیسه,Rod High School,0,3,958,1558,2519
13,1302,1302027,فیوزخیلو عالی لیسه,Feroz Khil High School,0,5,407,512,924
13,1302,1302028,سلام خیل مکتب,Salam Khil School,0,5,432,643,1080
13,1302,1302029,سرګ ملنګ کلینیک,Sarkai Malang Clinic,0,10,350,608,968
13,1302,1302030,حسن کلا لیسه,Hassan Kala High School,0,3,1167,574,1744
13,1302,1302031,د مموزیو منځن ښوونځ,Mamozai Secondary School,0,11,1768,1169,2948
13,1302,1302032,د مچلغو لیسه,Machghalo High School,0,58,2311,2197,4566
13,1302,1302033,بورګ مكتب,Borgai School,0,96,2299,1079,3474
13,1302,1302034,اخند خیلو منځن ښوونځ,Akhund Khil Secondary School,0,201,1683,1025,2909
13,1302,1302035,د فاضل خیلو جامع جومات,Fazel Khil Jame Mosque,0,84,556,502,1142
13,1302,1302036,متوسطه منصور خیل,Mansour Khil Secondary School,0,59,1160,529,1748
13,1302,1302023,خواجه علی زیارت, Khwaja Ali Zyarat,0,194,206,360,760
13,1303,1303038,ولسوالی مرکز ارمه,District Center Armah,0,1,52,113,166
13,1303,1303048,د باتور لیسه,Batoor High School,0,0,0,1104,1104
13,1303,1303049,د مقرب خیلو مدرسه,Muqarab Khil Madrassah,0,0,0,1006,1006
13,1303,1303050,کلینیک سهاک,Sahak Clinic,0,62,73,944,1079
13,1303,1303051,سهاک لیسه,Sahak High School,0,13,399,2276,2688
13,1303,1303052,هیبت مکتب,Haibat School,0,40,82,1864,1986
13,1303,1303053,شمول زای مکتب,Shamolzai School,0,9,62,75,146
13,1303,1303054,د شاگوم بالاه مدرسه,Shagom Bala Madrassah,0,0,591,0,591
13,1303,1303055,د گرج مسجد,Dagar Ji Mosque,0,24,348,2079,2451
13,1303,1303056,د دولت خان د کلی مسجد,Dawlat Khan village Mosque,0,86,58,541,685
13,1303,1303057,کولالگو لیسه,Kolalgo High School,0,1,192,2255,2448
13,1303,1303058,د اتفاق مکتب,Itefaq School,0,7,235,2273,2515
13,1303,1303059,کوټ خیل مکتب,Koti Khil School,0,313,86,631,1030
13,1303,1303060,د دولت زویو لیسه,Dawlat Zai High School,0,307,426,412,1145
13,1303,1303061,د نوی کوهی مسجد,Nawe Kohi Mosque,0,1,221,2182,2404
13,1303,1303062,ایمن خیل مدرسه,Aimani Khil Madrassah,0,0,205,2041,2246
13,1303,1303063,د زوړ کوهی مدرسه,Zorr Kohi Madrassah,0,3,105,1734,1842
13,1303,1303064,حبیب الله لیسه,Habibullah High School,0,1,322,2313,2636
13,1303,1303065,الوزو مکتب,Alozo School,0,0,214,1268,1482
13,1303,1303066,مکتب سورګ,Soorkai School,0,8,233,1148,1389
13,1303,1303067,کم جمالی کلی مسجد,Kam Jamali village Mosque,0,1,75,429,505
13,1303,1303037,شاهی کوت مکتب, Shahi Kot School,0,4,52,1720,1776
13,1304,1304068,د شبک ابتدائیه مکتب,Shabak Primary School,0,4,821,1166,1991
13,1304,1304069,لیسه ابراهیم خیل,Ibrahim Khil High School,0,2,1169,1336,2507
13,1304,1304070,د غلګ ابتدایه ښوونځ,Ghalgai Primary School,0,2,1765,2304,4071
13,1305,1305071,مکتب نصری بابا,Nasri Baba School,0,1,583,1153,1737
13,1305,1305072,اډه مسجد,Adah Mosque,0,1,569,898,1468
13,1305,1305073,موټ مسجد,Moti Mosque,0,0,1169,1181,2350
13,1305,1305074,د مکتب خیمه,School tent,0,0,377,404,781
13,1305,1305075,غورګ کلی مکتب,Ghorkai village School,0,0,199,831,1030
13,1305,1305076,وزی ابتدائیه مکتب,Wazai Primary School,0,0,410,666,1076
13,1305,1305077,لوټه مسجد,Lotah Mosque,0,0,325,721,1046
13,1305,1305078,غورګ خوله مدرسه,Ghorkai Kholah Madrassah,0,0,204,586,790
13,1305,1305079,سرګوړی کاریز ابتدایه مکتب,Sargorrai Karez Primary School,0,0,338,784,1122
13,1305,1305080,مسجد مته خیل,Mata Khil Mosque,0,1,1176,1743,2920
13,1305,1305081,مسجد شلم,Shalam Mosque,0,0,555,1166,1721
13,1305,1305082,د کی لگد جومات,Keen Lagad Mosque,0,1,563,589,1153
13,1305,1305083,ابتدائیه مکتب,Primary School,0,0,590,1149,1739
13,1306,1306091,د بوقر مسجد,Boqar Mosque,0,10,1755,1715,3480
13,1306,1306093,خان خیلو مکتب,Khan Khil School,0,0,1169,1744,2913
13,1306,1306094,د خوشحال خیلو مدرسه,Khoshal Khil Madrassah,0,4,222,519,745
13,1306,1306096,دشجنک مکتب,Shajanak School,0,1,562,573,1136
13,1306,1306097,د سمی خیلو مدرسه,Sameen Khil Madrassah,0,2,1148,1169,2319
13,1306,1306098,مسجد کاریز,Karez Mosque,0,3,1166,1139,2308
13,1306,1306099,د خند خیلو مکتب,Khand Khil School,0,13,684,565,1262
13,1306,1306100,د شیخانو مسجد,Shiekhano Mosque,0,1,490,710,1201
13,1306,1306101,سید کرم ولوسوالی مرکز,Sayed Karam District Center,0,1,488,982,1471
13,1306,1306102,کوندر خیلو مسجد,Kondar Khilo Mosque,0,11,792,1025,1828
13,1306,1306103,لوی خوړ مسجد,Loy Khwarr Mosque,0,0,634,754,1388
13,1306,1306104,مچ مسجد,Mach Mosque,0,0,586,894,1480
13,1307,1307105,د کوټگ مسجد,Kotkai Mosque,0,2,1166,1143,2311
13,1307,1307106,ګل غونډی مسجد,Gul Ghundai Mosque,0,2,1751,2326,4079
13,1307,1307107,دسورګل مكتب,Soor Gul School,0,12,1765,1747,3524
13,1307,1307108,محمد الله مکتب,Mohammadullah School,0,1,1182,1183,2366
13,1307,1307109,د فقی بابا مکتب,Faqeer Baba School,0,16,2253,2347,4616
13,1307,1307110,پټلاو کلینیک,Patlaw Clinic,0,1,935,757,1693
13,1307,1307112,د احمد خیلو مکتب,Ahmad Khil School,0,0,829,2179,3008
13,1307,1307113,خوازی خیل سپی مسجد,Khwazi Khil Speen Masjid Mosque,0,0,1130,564,1694
13,1307,1307114,د کڼه خیلو مکتب,Kanna Khil School,0,0,1149,1762,2911
13,1307,1307115,محرم استیا ښوونځ,Mahram Astya School,0,0,580,588,1168
13,1307,1307118,دبدالی مكتب,Badali School,0,2,1130,1624,2756
13,1307,1307119,زرا خیل مدرسه,Zarakhil Madrassah,0,3,1378,1554,2935
13,1307,1307120,صالح کوټ مسجد,Saleh Koti Mosque,0,1,1118,1101,2220
13,1307,1307121,د شگ مسجد,Shagai Mosque,0,2,1170,1507,2679
13,1307,1307122,دخیمن مكتب,Khairmani School,0,2,2277,2078,4357
13,1307,1307123,سرواڼ خيل مكتب,Sarwan Khil School,0,0,585,1120,1705
13,1307,1307124,د ماری خیلو مکتب,Mari Khil School,0,2,556,587,1145
13,1307,1307125,د روکیانو مدرسه,Rokyano Madrassah,0,1,582,535,1118
13,1307,1307126,د حسن الگادی مسجد,Hasan Algadi Mosque,0,1,553,581,1135
13,1307,1307127,د خرلوټ شفاخانه,Kharloti Hospital,0,0,577,585,1162
13,1307,1307111,د علی سنګیو کلینیک, Ali Sangai Clinic,0,1,1735,1750,3486
13,1307,1307116,سنګر مسجد, Sangar Mosque,0,1,2762,2196,4959
13,1308,1308128,کلینیک موشکه,Moshkah Clinic,0,0,409,617,1026
13,1308,1308129,میازی مکتب,Mirazi School,0,0,462,505,967
13,1308,1308130,د دولت خیلو مسجد,Dawlat Khil Mosque,0,0,819,999,1818
13,1308,1308131,میازی لیسه,Meerazi High School,0,0,574,548,1122
13,1308,1308132,مسجد ترکن سکندرخیل,Tarkanani Sikandar Khil Mosque,0,0,578,793,1371
13,1308,1308133,سکندر خیل عالی لیسه,Sikandar Khil High School,0,0,1186,1169,2355
13,1308,1308134,د سکندر خیل اناثو مکتب,Sikander Khil Girls School,0,0,1184,1168,2352
13,1308,1308135,دموټ مكتب,Moti School,0,0,1137,1141,2278
13,1308,1308136,مسجد سلیمان خیل,Sulaiman Khil Mosque,0,0,800,960,1760
13,1308,1308137,مسجد ونس خیل,Wanas Khil Mosque,0,2,1180,1176,2358
13,1308,1308138,د جنازی باغ کلینیک,Jenaza Bagh Clinic,0,2,588,1186,1776
13,1308,1308139,د شوات مکتب,Shwat School,0,2,1244,1166,2412
13,1308,1308140,شوات کلینیک,Shwat Clinic,0,1,1184,1171,2356
13,1308,1308141,د مخگ کلی جامع مسجد,Da Makhki Kali Jame Mosque,0,0,589,590,1179
13,1309,1309142,د چیناری مدرسه,Chinari Madrassah,0,0,467,595,1062
13,1309,1309143,د می الګاډی مسجد,Da Manzal Gadai Mosque,0,1,1758,1150,2909
13,1309,1309144,موله ګل مسجد,Mulla Gul Mosque,0,2,1164,1166,2332
13,1309,1309146,د درندي مسجد,Da Drande Mosque,0,1,1568,2250,3819
13,1309,1309147,جاټ خیلو عالی لیسه,Jani Khil High School,0,0,1581,3455,5036
13,1309,1309148,چلم مكتب,Rubat High School,0,1,212,1259,1472
13,1309,1309149,موټ کلی مسجد,Moti village Mosque,0,0,263,327,590
13,1309,1309150,اورگور لیسه,Awgur High School,0,0,1156,1165,2321
13,1309,1309151,مسجد کوټکی,Kotki Mosque,0,0,1181,595,1776
13,1310,1310152,د ولسوالی مرکزی شفاخانه,District Center Hospital,0,1,819,2109,2929
13,1310,1310153,چمکنیو عالی لیسه,Chamkanai High School,0,8,699,1855,2562
13,1310,1310154,کوز حصارک کلی مسجد,Koz Hesarak Kali Mosque,0,8,792,775,1575
13,1310,1310155,د منده خیلو لیسه,Manda Khil High School,0,1,928,1931,2860
13,1310,1310156,د سلیمان خیل مسجد,Sulaiman Khil Mosque,0,4,1770,1756,3530
13,1310,1310157,چنار مسجد,Chinar Mosque,0,1,1191,1177,2369
13,1310,1310158,د لوا ړی مدرسه,Lowarre Madrassah,0,0,587,1155,1742
13,1310,1310159,بابو خیلو مکتب,Babu Khil School,0,1,780,1261,2042
13,1310,1310160,کوز نوآباد کلی مسجد,Koz Nawabad Kali Mosque,0,2,1764,1766,3532
13,1310,1310162,بر منگلیار مسجد,Bar Mangalyar Mosque,0,3,1787,1172,2962
13,1310,1310163,د عید گل مسجد,Eid Gul Mosque,0,1,622,893,1516
13,1310,1310164,د بګیاړ مکتب,Bagyarr School,0,1,1174,1177,2352
13,1310,1310165,د بګیاړ مسجد,Bagyarr Mosque,0,2,1751,1778,3531
13,1310,1310161,د نرګسی مکتب, Nargesi School,0,0,598,1160,1758
13,1311,1311166,د سورګ مسجد,Soorgi Mosque,0,0,1139,1173,2312
13,1311,1311168,سلتک مقبل متوسطه مکتب,Saltak Moqbil Secondary School,0,2,1784,1784,3570
13,1311,1311169,سپی جومات,Speen Jomat Mosque,0,1,1164,1183,2348
13,1311,1311170,شیوانه الګاډه مکتب,Sherwanah Algaddah School,0,2,621,1502,2125
13,1311,1311171,مټورخ مسجد,Matawarkh Mosque,0,0,1176,1142,2318
13,1311,1311172,مسجد شپولی خوله,Shpole Khola Mosque,0,0,786,568,1354
13,1311,1311173,د نجونو میټ خونزی,Girls Secondary School,0,1,908,579,1488
13,1311,1311174,دمومی کلی جومات,Momin Kali Mosque,0,1,920,463,1384
13,1311,1311175,تعمی ولسوالی,District Building,0,0,1157,646,1803
13,1311,1311176,ميمحمد الدین جومات,Mir Mohammaduddin Mosque,0,0,804,831,1635
13,1311,1311177,د میحسن جامع جومات,Mir Hasan Jame Mosque,0,2,1172,1156,2330
13,1311,1311167,متوسطه مکتب, Secondary School,0,1,1179,1184,2364
13,1311,1311178,د درنګ متوسط مکتب, Darang Secondary School,0,1,1764,578,2343
13,1312,1312179,سرابک ابتدائیه مکتب,Sharabak Primary School,0,2,579,576,1157
13,1312,1312180,مکتب توشنک,Tushnak School,0,2,1707,2310,4019
13,1312,1312181,للک کهول مدرسه,Lalak Kahool Madrassah,0,1,1727,591,2319
13,1312,1312182,خیاټ مکتب,Khairani School,0,1,1244,2015,3260
13,1312,1312183,لجه ابتدائیه مکتب,Lajjah Primary School,0,0,1137,821,1958
13,1312,1312184,ښارګ مسجد,Kharkai Mosque,0,0,368,285,653
13,1312,1312185,ولسوالی مکتب,District School,0,0,519,185,704
13,1312,1312186,دودی مسجد,Dodi Mosque,0,0,583,584,1167
13,1312,1312187,مکتب لجه منګل,Lajjah Mangal School,0,2,2255,1759,4016
13,1313,1313190,د خلیلانو عالی لیسه,Khalilan High School,0,0,577,436,1013
13,1313,1313191,نائب الدین مسجد,Nayebuddin Mosque,0,0,753,751,1504
13,1313,1313192,مکتب چورړکای,Chorarrkai School,0,0,193,194,387
13,1313,1313193,صحبن کلی,Suhbati School,0,0,74,632,706
13,1313,1313194,دغونزي مسجد,Da Ghownzi Mosque,0,0,1766,739,2505
13,1313,1313195,انډوام متوسطه مکتب,Andwam Secondary School,0,0,1151,1169,2320
13,1313,1313196,دگرندی خولی مسجد,Da Grandi Khowli Mosque,0,3,1157,1169,2329
13,1313,1313197,یارالدین مسجد,Yaruddin Mosque,0,23,1459,1143,2625
13,1313,1313188,ګرمی مکتب, Garmmi School,0,9,1749,1174,2932
13,1313,1313189,دحاجیانو کلی مسجد, Hajiano Kali Mosque,0,0,703,78,781
13,1314,1314084,میاجان مسجد,Mirajan Mosque,0,0,341,608,949
13,1314,1314085,خړ خیل مسجد,Kharr Khil Mosque,0,0,587,1176,1763
13,1314,1314086,گرده څیی کلینیک,Gerdah Serrai Clinic,0,0,0,470,470
13,1314,1314087,زرغون راغه د مکتب ځای,Zarghoon Ragha School location,0,0,1186,1177,2363
13,1314,1314088,توریخیلو مرکزی مسجد,Tori Khil Markazi Mosque,0,0,1144,1179,2323
13,1314,1314089,فخری دوکانونه مسجد,Fakhri dokanoonah Mosque,0,0,588,591,1179
13,1315,1315039,نوی مدرسه,Nawai Madrassah,0,2,309,2279,2590
13,1315,1315040,صالح خیل مدرسه,Saleh Khil Madrassah,0,47,472,2285,2804
13,1315,1315041,بابل خیل د کلی مسجد,Babul Khil village Mosque,0,51,417,2257,2725
13,1315,1315042,منیجور روحاټ بابا مسجد,Menjawar Rouhani Ba Ba Mosque,0,210,184,1111,1505
13,1315,1315043,د خر مست خیلو مسجد,Khar Mast Khilo Mosque,0,0,64,852,916
13,1315,1315044,د مامو زیو کلینیک,Mamozai Clinic,0,42,87,203,332
13,1315,1315045,د شاه حیدر مسجد,Shah Haider Mosque,0,31,112,316,459
13,1315,1315046,د رحمن خیلو مسجد,Rahman Khil Mosque,0,1,0,1395,1396
13,1315,1315047,د نیک نام مسجد,Nek Nam Mosque,0,1,199,539,739
14,1401,1401001,حاج زار پایو خان جومات,Haji Zar Payo Khan Mosque,0,6,353,670,1029
14,1401,1401002,د ښځو چارو رياست,Women Affairs Directorate,0,0,497,674,1171
14,1401,1401003,د غازي بیک ځدران پارک,Ghazi Babrak Zadran Park,0,18,93,2451,2562
14,1401,1401004,مرکزي جومات,Central Mosque,0,124,178,5821,6123
14,1401,1401005,د يعقوبيو اډې جومات,Yaoubaio Adah Mosque,0,53,92,2801,2946
14,1401,1401006,د الفتځ مرکزي لیسه,Alfatah Markazi High School,0,9,100,1227,1336
14,1401,1401007,پخواڼ ملکی روغتون,Old Civil Hospital,0,23,423,959,1405
14,1401,1401008,معيوبينو رياست,Directorate of Persons with Disability,0,216,413,2705,3334
14,1401,1401009,د شهيد محمد داود ښوونځ,Shaheed Mohammad Daoud School,0,0,31,358,389
14,1401,1401010,د ګمرکاتو د کور جومات,Customs House Mosque,0,24,545,2876,3445
14,1401,1401011,د ماڼ کل جومات,Manni Village Mosque,0,6,0,891,897
14,1401,1401012,د بوده خان جومات شمل مرديخېل,"Budah Khan Mosque, Shamal Mardikhil",0,8,128,590,726
14,1401,1401013,د ورده خیلو کل جومات,Warda Khil village Mosque,0,0,67,363,430
14,1401,1401014,د تورغونډى مکتب,Tour Ghundai School,0,16,19,900,935
14,1401,1401015,د بانک باغ د سی کل جومات,Bangi Bagh Ster Kali village Mosque,0,14,109,770,893
14,1401,1401016,د شمل زوړ کل جومات (نورزى),Da Shamal Zorr Kali (Noorzai) Mosque,0,77,32,308,417
14,1401,1401017,د نوروزیو لیسه,Da Nawrozai High School,0,360,45,599,1004
14,1401,1401018,دډنډا پانو پاس کل جومات,Danda Pano Pas Kali Mosque,0,3,70,272,345
14,1401,1401019,د مل یو د جرګو تالار,Malizai Jirga Hall,0,40,51,335,426
14,1401,1401020,شمل ګډه خاره حسن کوټ مکتب,Shamal Gada Kharah Hasan Kot School,0,8,342,784,1134
14,1401,1401021,غازی آباد کل ابتدائیه مکتب,Ghazi Abad Village Primary School,0,1175,25,244,1444
14,1401,1401022,د پاسن پال جومات,Paste Pale Mosque,0,0,2,0,2
14,1401,1401023,د سرباز جومات,Sarbaz Mosque,0,12,738,3207,3957
14,1401,1401024,د سروک کل جومات (لکڼ),Saroki village (Lakann) Mosque,0,15,659,1154,1828
14,1401,1401025,سرکیو بړیو جماعت,Sarkai Barraio Mosque,0,20,282,717,1019
14,1401,1401026,د ټانګ کل جومات,Tang village Mosque,0,9,293,1133,1435
14,1401,1401028,دډیري مرکزي جومات,Deeri central Mosque,0,27,381,688,1096
14,1401,1401029,د سرک جان کل جومات شمل,Sarki Jan village Mosque Shamal,0,27,355,846,1228
14,1401,1401030,د جرګوتالارمتون چین کل,"Jirga Hall, Matoon Cheni village",0,2,250,972,1224
14,1401,1401031,د مديخيل کل مدرسه,Madikhil village Madrassah,0,1,0,477,478
14,1401,1401032,د منګسو کل جومات,Magaso village Mosque,0,1,162,939,1102
14,1401,1401033,د کونډیو کل جومات,Kondaio village Mosque,0,0,295,1232,1527
14,1401,1401034,کامران کل دجامع جماعت,Kamran village Jame Mosque,0,95,152,1310,1557
14,1401,1401035,خاڼ خوړ جومات,Khani Khwarr Mosque,0,1153,131,1259,2543
14,1401,1401036,جومات مزغوره کل,Mazghora village Mosque,0,0,63,445,508
14,1401,1401037,د اڅړښونځ,Assar School,0,0,78,0,78
14,1401,1401038,د منګل کوټ کل جومات,Mangal Kot village Mosque,0,297,208,1553,2058
14,1401,1401039,د څارنکوټ جومات,Sarangot Mosque,0,0,177,615,792
14,1401,1401040,د تازه کل جومات متون,"Taza Kali Mosque, Matoon",0,108,239,867,1214
14,1401,1401041,متون منديخيل جومات,Matoon Mandi Khil Mosque,0,1,415,1147,1563
14,1401,1401042,د خبشخیلو جومات,Khabshkhilo Mosque,0,5,437,1174,1616
14,1401,1401043,دریخیلو جومات,Darikhilo Mosque,0,1,153,581,735
14,1401,1401044,د کوټول کل جومات,Kotwalai village Mosque,0,0,65,395,460
14,1401,1401045,چیعی کل جماعت,Cheeghe village Mosque,0,0,140,362,502
14,1401,1401046,د کجیې کل جومات,Kajeeri village Mosque,0,2,189,619,810
14,1401,1401047,جومات کاروان سراى,Karwan Sarai Mosque,0,1,103,754,858
14,1401,1401048,د عمرخان کل جومات,Omer Khan village Mosque,0,0,103,403,506
14,1401,1401049,د محمود خیلو لیسه,Mahmoud Khil High School,0,9,44,569,622
14,1401,1401050,غرغښت ابتدايه ښونځ,Gharghakht Primary School,0,2,245,845,1092
14,1401,1401051,د ګیډی کل جومات,Geedi village Mosque,0,16,190,780,986
14,1401,1401027,د ایوب خیلو لیسه, Ayub Khil High School,0,36,324,1994,2354
14,1402,1402052,د تورې وړى ليسه ديګان,Tore Warrai Degan High School,0,2,168,453,623
14,1402,1402053,د دیګانو کل جامع جومات,Degan village Jame Mosque,0,4,588,841,1433
14,1402,1402054,د سلم کل مرکز جومات,Salam village Central Mosque,0,0,112,288,400
14,1402,1402055,د حيدرخيلو محمد صديق روه ليسه,"Mohammad Sediq Rohi, Haider Khil High School",0,0,354,1600,1954
14,1402,1402056,ځدراڼ کوټ جومات,Zadran Kot Mosque,0,0,21,245,266
14,1402,1402057,د ورزې کل جومات,Warze village Mosque,0,10,321,1330,1661
14,1402,1402058,دحيدرخيلو دسموات ښوونځ,Haider Khil Samwat School,0,1,105,339,445
14,1402,1402059,شیزاعل جومات,Sherza Ali Mosque,0,0,259,466,725
14,1402,1402060,ب کل ښوونځ,B village School,0,0,163,898,1061
14,1402,1402061,د ډاډوالو ښکل جومات,Dadwalo Khkulai Mosque,0,1,614,965,1580
14,1402,1402062,جومات حسن محمد,Hasan Mohammad Mosque,0,0,118,459,577
14,1402,1402063,د چنداړ صحرا کل جومات,Chandar Sahra Kali village Mosque,0,0,16,245,261
14,1402,1402064,د چنداړ کل جومات,Chandar village Mosque,0,0,144,509,653
14,1402,1402065,د ميټا خان ليسه,Meta Khan High School,0,2,287,1510,1799
14,1402,1402066,عجب خان کل جومات درنام,Ajab Khan village Mosque,0,6,241,1296,1543
14,1402,1402067,دحسن زيو د نجونو ليسه,Hassan Zai Girls High School,0,3,369,1117,1489
14,1402,1402068,شډل کل جومات,Shadal Kali Mosque,0,0,170,433,603
14,1402,1402069,د دلپوريو متوسطه ښوونځ,Dilporaio Secondary School,0,1,116,1357,1474
14,1403,1403070,د کاڅک کل جومات,Kaski kali Mosque,0,2,361,332,695
14,1403,1403071,د ژوره کل جومات,Da Zhawarah Kali Mosque,0,0,490,690,1180
14,1403,1403072,د چنار سنګر ابتدایه ښوونځ,Chinar Sangar Primary School,0,599,18,150,767
14,1403,1403073,د تودی چین ابتدایه ښوونځ,Tawde Cheene Primary School,0,44,564,983,1591
14,1403,1403074,د میداڼ کل کلینیک,Maidani village Clinic,0,168,776,1411,2355
14,1403,1403075,د شهيد محمد قادر ليسه,Shaeed Mohammad Qader High School,0,1,179,1078,1258
14,1403,1403076,د علیداڼ سی جومات,Ali Dayee Mosque,0,1,224,706,931
14,1403,1403077,د جانباز جومات,Janbaz Mosque,0,4,604,830,1438
14,1403,1403078,شیخ امی لیسه,Shiekh Amir High School,0,17,277,1437,1731
14,1403,1403079,د زوالدين ليسه,Zualdin High School,0,0,14,634,648
14,1403,1403080,د بوري خیلو ښوونځ,Boree Khil School,0,0,311,218,529
14,1404,1404081,دسیناکیوعال لیسه,Senakai High School,0,0,163,1114,1277
14,1404,1404082,داطمان ښوونځ,Atman School,0,2,448,570,1020
14,1404,1404083,حکمین ابتدایه ښوونځ,Hakmeena Primary School,0,0,115,851,966
14,1404,1404084,د درک عال لیسه,Dargai High School,0,2,551,1115,1668
14,1404,1404085,دلیی ذکور ابتدایه مکتب,Lajjah Boys Primary School,0,0,171,225,396
14,1404,1404086,دګلاپ خان عال لیسه,Gulab Khan High School,0,0,176,437,613
14,1404,1404087,عمرفاروق جومات,Omer Farouq Mosque,0,0,112,230,342
14,1404,1404089,د من کل جومات,Manni Kali Mosque,0,2,100,431,533
14,1404,1404090,ددورملکی عال لیسه,Dur Malika High School,0,1,498,936,1435
14,1404,1404091,دژی کل دنجونوښونځ,Da Zhai Kali Girls School,0,0,439,745,1184
14,1404,1404092,د پیبادشاه کل د نجونو عال لیسه,Peer Badshah village Girls High School,0,0,154,668,822
14,1404,1404093,حاج نيک محمد کل ښونځ,Haji Nek Mohammad Kali School,0,0,105,487,592
14,1404,1404094,دحصارک ښوونځ,Hesarak School,0,0,592,817,1409
14,1404,1404095,د لاغوړي عال لیسه,Laghori High School,0,0,365,471,836
14,1404,1404096,دداخیودهلکانولیسه,Dakhi Boys High School,0,0,324,789,1113
14,1404,1404097,دګوج متوسطه مکتب,Gokhi Secondary School,0,0,111,90,201
14,1404,1404098,دمتک عال لیسه,Mataki High School,0,0,304,342,646
14,1404,1404099,د بنده خیلو متوسطه ښوونځ,Banda Khil Secondary School,0,6,61,370,437
14,1404,1404100,دکوچانو متوسطه ښوونځ,Kochiano Secondary School,0,1,595,613,1209
14,1404,1404101,پځ چری جومات,Pakhe Chari Mosque,0,0,372,1272,1644
14,1404,1404102,دکڼک ماڼ جومات,Da Kanngai Mannai Mosque,0,0,224,280,504
14,1404,1404103,د ورژل مدرسه,Warzhalai Madrassah,0,0,172,282,454
14,1404,1404104,د نریزې عال لیسه,Da Nareeze High School,0,0,543,926,1469
14,1404,1404105,سورکوټ متواسطه ښوونځ,Sor Kot Secondary School,0,0,222,204,426
14,1404,1404088,ضیاالمدارس مدرسه, Ziaul Madares Madrassah,0,1,330,429,760
14,1405,1405106,موسی خیل د توت پاله جومات,Musa Khil Toot Palah Mosque,0,10,914,2043,2967
14,1405,1405107,موسی خیل د پایکو میل جومات,Musa Khil Da Paiko Melay Mosque,0,1,1411,1471,2883
14,1405,1405108,د غرڼ تن جومات,Da Gharani Tapeh Mosque,0,0,53,446,499
14,1405,1405109,د مرغ جومات,Da Marghai Mosque,0,3,321,377,701
14,1405,1405110,سردارخان ترک جومات,Sardar Khan Taraki Mosque,0,0,243,159,402
14,1405,1405111,د مرغ عال لیسه,Marghai High School,0,1,68,321,390
14,1405,1405112,د مندي جومات,Mandi Mosque,0,0,0,451,451
14,1405,1405113,د سپیاویل ښوونځ,Spera Welai School,0,1,182,121,304
14,1405,1405114,د پاړوخیلو جومات,Parro Khil Mosque,0,0,0,5,5
14,1405,1405115,د خوشمند کل جومات,Khoshamand Village Mosque,0,1,911,1135,2047
14,1405,1405116,د حضت بیلال جومات,Hazrat Bilal Mosque,0,0,713,614,1327
14,1405,1405117,د عجب خان جومات کوسي خوله,"Ajab Khan Mosque, Koseen Kholah",0,0,380,392,772
14,1405,1405118,د وچکړي کل جومات,Wachkarrai village Mosque,0,0,858,730,1588
14,1406,1406119,د لټک کل جومات,Latkai village Mosque,0,0,230,2273,2503
14,1406,1406120,د شمبوات ښوونځ,Shambowat School,0,1,134,1712,1847
14,1406,1406124,د کيځ کل جومات,Keekhe Kali Mosque,0,0,239,561,800
14,1406,1406125,د غوړشن کل د جرګو تالار,Ghorshtai village Jirga Hall,0,0,61,154,215
14,1406,1406126,د المارې ښوونځ,Almari School,0,0,289,1083,1372
14,1406,1406127,ماکوش جومات,Makosh Mosque,0,2,196,462,660
14,1406,1406128,د جهانمی جومات,Jehamir Mosque,0,0,195,1149,1344
14,1407,1407129,دیعقوبیوبادشاه دین مسجد,Yaqoubai Badshah Din Mosque,0,21,229,1404,1654
14,1407,1407130,دیعقوڼ ولسوال مسجد,Yaoubai District Mosque,0,0,336,2773,3109
14,1407,1407131,دمتخیلوکل مسجد,Mata Khilo village Mosque,0,0,233,1049,1282
14,1407,1407132,کورړو جومات,Korrho Mosque,0,16,436,821,1273
14,1407,1407133,دنوری کل مکتب,Noori village School,0,5,1758,2986,4749
14,1407,1407134,جومات کاريز کل,Karez Kali Mosque,0,1,580,1755,2336
14,1407,1407135,زمیجوات,Zambar Mosque,0,1,487,3563,4051
14,1407,1407136,د موج کل ښوونځ,Mochi village School,0,32,572,3283,3887
14,1408,1408138,د اورمړکل جومات,Awrmarr village Mosque,0,2,566,2505,3073
14,1408,1408139,قدم جومات,Qadam Mosque,0,10,1125,2305,3440
14,1408,1408140,د تورو اوبو جومات,Da Toro Obo Mosque,0,6,286,1738,2030
14,1408,1408142,چرګوڼ جومات,Chagotai Mosque,0,477,8,150,635
14,1408,1408144,حاج نعیم کوج جومات,Haji Naeem Kochai Mosque,0,103,60,0,163
14,1408,1408145,میام ګل کل زمان خيل جومات,"Meeram Gul village, Zaman Khil Mosque",0,396,7,822,1225
14,1408,1408146,جومات چينګاى,Cheengai Mosque,0,0,567,2130,2697
14,1408,1408147,د پاله جامع جومات,Pallah Jame Mosque,0,16,222,507,745
14,1408,1408148,مرکزي باغ بلاوټ,Markazi Bagh Belawat,0,0,226,1725,1951
14,1408,1408149,جومات مندينه,Mandeenah Mosque,0,2,166,408,576
14,1408,1408150,کوزه بوخانه مرکزی جومات,Kozah Bokhanah central Mosque,0,3,26,257,286
14,1409,1409151,پاس ترک جمعی جماعت,Pas Tarak,0,3,999,1043,2045
14,1409,1409152,ښوونځ کوټک عوازي کل,Kotki Awazi village School,0,1,549,407,957
14,1409,1409153,د انار کل مرکزي جومات,Anar Kali Mosque,0,0,0,878,878
14,1409,1409154,د باک ولسوال مرکزی لیسه,Bak District Center High School,0,3,851,2295,3149
14,1409,1409156,توتک ښوونځ,Totak School,0,0,162,1262,1424
14,1409,1409155,د شمل خیلو مکتب, Shamal Khil School,0,0,492,878,1370
14,1410,1410157,پایکو میل جوملت,Paiko Mile Jawmillat,0,0,233,333,566
14,1410,1410158,د منګلو مدرسه,Mangalo Madrassah,0,0,15,164,179
14,1410,1410159,د سرو اوبو منځن ښونځ,Sarro Obo Secondary School,0,2,158,542,702
14,1410,1410160,د قلندر کلینیک,Qalandar Clinic,0,0,576,1135,1711
14,1410,1410161,مسلم اباد مسجد,Muslim Abad Mosque,0,0,497,1530,2027
14,1410,1410162,د ظریف لوڼ هوار میدان,Zareef Lotte Plain ground,0,0,580,968,1548
14,1410,1410163,د پیجومات,Da Peer Mosque,0,0,54,255,309
14,1411,1411164,د کل د لمن خيم,Village ground tents,0,2,35,1115,1152
14,1411,1411165,ضڼ دوکانونه,Zarbi dukanoonah (Shops),0,1,67,312,380
14,1411,1411166,د لاک تیې مدرسه,Lahe Tegge Madrassah,0,1,167,1092,1260
14,1411,1411167,د پړوند اڅړخيلو کل جومات,Parwandh Asarrkhilo village Mosque,0,2,127,578,707
14,1411,1411168,د برخيلو مندڼ,Barkhilo Mandayee,0,1,451,937,1389
14,1411,1411169,شينشوڼ کاڅک,Sheenshobi Kaski,0,4,34,455,493
14,1411,1411170,سپیه کل ښوونځ,Sperah village School,0,6,201,1241,1448
14,1411,1411171,د ډنډک کل جومات,Da Dandaki Kali village Mosque,0,0,181,919,1100
14,1411,1411172,غلام جان دوکان تروې کل,Ghulam Jan Dukan Tarwe Kalai,0,1,5,506,512
14,1411,1411173,هوار ميدان (غورمه),Plain ground (Ghormah),0,4,23,1140,1167
14,1411,1411174,د خوست خيل کل او دوکانونه,Khost Khil village and Shops,0,7,36,655,698
14,1412,1412175,د سری کاڼ کل جومات,Sre Kanni village Mosque,0,0,66,234,300
14,1412,1412176,د دوه منده ښوونځ,Dwah Mandah School,0,3,143,970,1116
14,1412,1412177,د برک کل لیسه,Bargi village High School,0,0,196,1263,1459
14,1412,1412178,د امی ګلستان جومات,Amir Gulistan Mosque,0,0,0,651,651
14,1412,1412179,د الوخیلو مدرسه,Alokhil Madrassah,0,0,180,802,982
14,1412,1412180,د سيد خيلو کلینيک,Sayed Khil Clinic,0,1,484,1155,1640
14,1412,1412181,د ایمار خیلو جومات,Imar Khilo Mosque,0,2,134,350,486
14,1413,1413182,سن ون ښوونځ,City One School,0,0,670,869,1539
14,1413,1413183,مدرسه زنخيل,Zankhil Madrassah,0,1,371,1147,1519
14,1413,1413184,د قبایلو د غونډ ښوونځ,Qabayel Ghond School,0,2,568,1526,2096
14,1413,1413185,ډیری میل لیسه,Deri Melay High School,0,1,1167,459,1627
14,1413,1413186,د اسکندرې ښوونځ,Iskandariah School,0,0,569,431,1000
14,1413,1413187,شيخانو جامع جومات,Shiekhano Jame Mosque,0,0,1052,951,2003
14,1413,1413188,د الګاډې ليسه,Algadi High School,0,19,583,761,1363
14,1413,1413189,ښوونځ اکاکهول,Aka Kahool School,0,0,668,813,1481
14,1413,1413190,د داڼ ښوونځ,Dani School,0,0,414,900,1314
14,1413,1413191,ساړې پيل ښونځ,Sarre Pelai School,0,1,190,744,935
14,1413,1413192,جگه شاویه میداڼ,Jaggah Shawyah Maidani (Jaggah Shawyah Ground),0,1,585,726,1312
15,1501,1501001,لیسه عمرا خان,Omara Khan High School,0,0,157,3167,3324
15,1501,1501002,ګورګام جامع مسجد,Gorgam Jami Mosque,0,1,419,611,1031
15,1501,1501004,شيخانو متوسطه,Shikhan Secondary School,0,0,46,205,251
15,1501,1501006,مکتب ابتدائیه تیشه,Tesha Primary School,0,1,205,819,1025
15,1501,1501007,سالار باغ متوسطه,Salar Bagh Secondary School,0,0,246,600,846
15,1501,1501008,شهید مینا ابتدائیه,Shaheed Mina Primary School,0,0,369,774,1143
15,1501,1501009,بلال مسجد,Bilal Mosque,0,1,1587,1434,3022
15,1501,1501010,صنایع مسلکی لیسه,Sanaye (industrial) Vocational School,0,1,670,1101,1772
15,1501,1501011,کرهالی انجونو لیسه,Kirhala Girls High School,0,0,1327,1327,2654
15,1501,1501012,مکتب ابتدائیه څاګ,Saagi Primary School,0,0,314,656,970
15,1501,1501013,دقاضیانو مسجد,Qaziano Mosque,0,0,416,632,1048
15,1501,1501014,د بری شګ مسجد,Bara Shagai Mosque,0,1,132,362,495
15,1501,1501015,د منځ څاګ مسجد,Manz Saagi Mosque,0,0,88,467,555
15,1501,1501003,هجرت بر کلی مسجد,Hijrat Bar Kalai Mosque,0,2,512,532,1046
15,1501,1501005,نواباد منځ کلی مسجد,Nawabad Manz Kalai Mosque,0,0,393,1483,1876
15,1502,1502018,ادم خیلو ابتدایه,Adam Khil Primary School,0,1,812,615,1428
15,1502,1502019,ليسه ذکور ډاګ,Daag Boys High School,0,0,73,186,259
15,1502,1502020,مکتب ابتدائیه خان غوندی,Khan Ghondi Primary School,0,0,789,2175,2964
15,1502,1502022,دلاهور ډاګ منځن ښونځ,Lahor Dag Secondary School,0,0,1651,1731,3382
15,1502,1502016,حصاری زراعت مسکلی لیسه,Hesari Agricultural High School,0,2,1346,1651,2999
15,1503,1503021,لیسه قمځ,Qamchi High School,0,0,289,912,1201
15,1503,1503023,مسجدقریه,Village Mosque,0,0,368,1401,1769
15,1503,1503024,مکتب ابتدائیه شین گام,Shini Gam Primary School,0,0,383,1136,1519
15,1503,1503025,مسجد قریه,Village Mosque,0,0,0,10,10
15,1504,1504029,مکتب ابتدائیه کوتګ,Kotaki Primary School,0,0,424,885,1309
15,1504,1504030,لیسه نرنګ,Narang High School,0,0,180,1101,1281
15,1504,1504031,کوډو نسوانو ابتدایه,Kodo Girls Primary School,0,0,301,1170,1471
15,1504,1504032,مکتب لمتک,Lamtak School,0,2,1003,1627,2632
15,1504,1504033,مکتب دختانه بر نرنګ,Bar Narang Girls School,0,4,757,877,1638
15,1504,1504034,لیسه بر نرنګ,Bar Narang High School,0,0,892,1166,2058
15,1505,1505037,لیسه دختانه بحراباد,Bahrabad Girls High School,0,65,1409,1987,3461
15,1505,1505038,مکتب ابتدائیه پشد,Pashad Primary School,0,48,1793,2144,3985
15,1505,1505039,مکتب ابتدائیه ټانګو,Tango Primary School,0,108,643,1275,2026
15,1505,1505040,مکتب ابتدائیه کوچیانو بیله,Kuchiano Bela Primary School,0,0,184,347,531
15,1505,1505041,مدرسه قریه دونان,Donayee Village Madrasa,0,0,372,458,830
15,1505,1505042,مدرسه قریه دوسرکه,Do Saraka Village Madrasa,0,5,296,813,1114
15,1505,1505043,سرکاڼو مرکزي لیسه,Sarkano Central High School,0,3,721,1706,2430
15,1505,1505044,مکتب ابتدايه مسلم اباد,Muslim Abad Primary School,0,1,354,450,805
15,1506,1506045,مکتب ابتدائیه شت کوړک,Shin Korak Primary School,0,2,1823,2445,4270
15,1506,1506046,لیسه شیګل,Shigal High School,0,0,456,1443,1899
15,1506,1506047,تعمت ولسوالی,District Governor Building,0,0,233,1092,1325
15,1506,1506048,مکتب ابتدائیه مون,Moni Primary School,0,0,164,664,828
15,1506,1506050,هلالزو متوسطه,Hilalzo Secondary School,0,0,172,1067,1239
15,1506,1506052,دیری کلینیک,Dirai Clinic,0,0,998,999,1997
15,1506,1506053,بر ناریت جامع مسجد,Bar Naarit Jami Mosque,0,1,701,1010,1712
15,1506,1506051,اتم کلی د نسوانو متوسه,Atam Village Girls Secondary School,0,1,559,579,1139
15,1507,1507055,مدرسه شهید متزا محمد,Shaheed Mirza Muhamad Madrasa,0,0,351,387,738
15,1507,1507056,ترړى هلکانو لومړن ښوونځ,Tar-ri Boys Primary School,0,0,367,638,1005
15,1507,1507057,لیسه بارکندی,Barkandi High School,0,0,987,1378,2365
15,1507,1507058,مکتب قریه کندګل,Kandgul Village School,0,0,180,1299,1479
15,1507,1507059,ټنټيل نسوانو متوسطه,Tantil Girls Secondary School,0,1,180,605,786
15,1507,1507060,مسجد قريه عثمان بن عفان,Osman Bin Affan Village Mosque,0,0,106,635,741
15,1507,1507061,مکتب ابتدائیه شاهیلام,Shahilam Primary School,0,0,250,405,655
15,1507,1507062,مدرسه قریه کندور,Kandaro Village Madrasa,0,0,364,409,773
15,1507,1507063,لیسه مانونګ,Manongi HighSchool,0,0,76,516,592
15,1507,1507064,ننګلام نسوانو لیسه,Nangalam Girls High School,0,0,1102,1270,2372
15,1507,1507065,وردیش نسوانو ابتدایه,Wardish Girls Primary School,0,0,81,283,364
15,1507,1507066,مسجد قريه خلقلام,Khalqlam Village Mosque,0,0,1191,1322,2513
15,1508,1508067,پلوڅوناو مکتب,Paloso Naw School,0,1,620,831,1452
15,1508,1508068,مدرسه دمبارو,Dambaro Madrasa,0,0,141,178,319
15,1508,1508069,ابتداییه ښوونځ,Primary School,0,0,378,1243,1621
15,1508,1508070,مسجد ولسوالی,District Mosque,0,0,67,1176,1243
15,1508,1508071,جځ لیسه,Jaji High School,0,0,593,757,1350
15,1508,1508072,مکتب دختانه زور اسمار,Zoor Asmar Girls School,0,0,472,1346,1818
15,1508,1508073,لیسه ذکور,Boys High School,0,1,509,410,920
15,1509,1509074,ګټو قلعه لیسه,Gato Qala High School,0,0,1364,2002,3366
15,1509,1509075,مکتب فیض الله,Faizullah School,0,0,711,1283,1994
15,1509,1509076,مسجد قریه کلمان,Kolmani Village Mosque,0,0,699,662,1361
15,1509,1509077,مسجد قریه ولی قلعه,Wali Qala Village Mosque,0,0,499,690,1189
15,1509,1509079,مکتب ابتدائیه با برو,Babaro Primary School,0,1,1056,1589,2646
15,1509,1509080,چیناری دین مدرسه,Chenari Religious School,0,0,559,986,1545
15,1509,1509083,مکتب ترناب,Tarnab School,0,0,245,782,1027
15,1509,1509078,لیسه جمعیت,Jamiat High School,0,0,845,1968,2813
15,1510,1510084,مسجد چمباړی,Chambari Mosque,0,1,503,490,994
15,1510,1510085,لیسه منگوال,Mangwal High School,0,4,1250,1080,2334
15,1510,1510086,مسجد قریه لوټان,Lotan Village Mosque,0,0,726,839,1565
15,1510,1510087,مکتب متوسطه خاص کت,Khas Kunar Secondary School,0,1,1042,1585,2628
15,1510,1510088,مسجد قریه کوزه اراض,Kooza Arazi Village Mosque,0,1,1109,1316,2426
15,1510,1510089,لیسه خاص کت,Khas Kunar High School,0,0,683,1477,2160
15,1510,1510090,لیسه حکیم آباد,Hakim Abad High School,0,0,930,1301,2231
15,1510,1510091,شمکار لیسه,Shamkar High School,0,3,993,1171,2167
15,1511,1511093,مرکزی بارګام مسجد,Markazi Bargam Mosque,0,0,259,425,684
15,1511,1511094,بارگام ابتدائیه مکتب,Bargam Primary School,0,0,81,332,413
15,1511,1511096,بارګام لیسه,Bargam High School,0,1,83,476,560
15,1511,1511098,څونک مسجد,Sonk Mosque,0,0,0,1,1
15,1511,1511095,مسجد جامع نیشگام,Nisha Gam Mosque,0,1,356,1092,1449
15,1512,1512105,مکتب ابتدائیه بیاداد,Biadad Primary School,0,1,839,1308,2148
15,1512,1512106,لیسه بر دانګام,Bar Dangam High School,0,0,133,2067,2200
15,1512,1512107,مدرسه دوبندى,Dobandi Madrasa,0,0,119,1483,1602
15,1513,1513111,مکتب ابتدائیه سیتی,Seenzai Primary School,0,0,78,620,698
15,1513,1513112,مسجد کندی,Kandi Mosque,0,1,141,556,698
15,1513,1513113,ماشوړى مسجد,Mashorri Mosque,0,0,117,210,327
15,1513,1513114,قلعه مدرسه,Qala Madrasa,0,0,140,465,605
15,1513,1513115,مکتب متوسطه گل سالک,Gul Salik Secondary School,0,0,44,1014,1058
15,1514,1514118,مسجد قریه کوز نورګل,Kooz Noor Gal Village Mosque,0,0,539,766,1305
15,1514,1514119,لیسه ذکور,Boys High School,0,0,577,1680,2257
15,1514,1514120,سيد امت فاطمى کلينک,Sayed Amin Fatimi Clinic,0,17,638,871,1526
15,1514,1514121,مکتب متوسطه پت,Patan Secondary School,0,1,1601,2369,3971
15,1515,1515124,مسجد قریه,Village Mosque,0,0,1227,1032,2259
15,1515,1515127,مکتب ابتدائیه مچ منه,Mach Mana Primary School,0,0,342,588,930
15,1515,1515129,لیسه بری کوت,Bari Kot High School,0,0,922,933,1855
15,1515,1515130,پاشنګر ابتدایه,Pashangar Primary School,0,1,1258,643,1902
15,1515,1515131,مکتب ابتدايه خانانو کڅ,Khanano Kas Primary School,0,0,844,1020,1864
15,1515,1515132,لیسه ناری,Narang High School,0,0,824,1053,1877
15,1515,1515133,مکتب ابتدایه ذکور,Boys Primary School,0,0,829,919,1748
15,1515,1515134,مکتب ابتدائیه زروکڅ,Zaro Kas Primary School,0,0,280,575,855
15,1516,1516136,شلت لیسه,Shelton High School,0,0,153,1028,1181
15,1516,1516137,بازار جامع مسجد,Bazaar Jami Mosque,0,2,298,1247,1547
16,1601,1601001,مسچدجامع چتاس,Chatras Jami Mosque,0,1,308,421,730
16,1601,1601002,دارالعلوم پشکی,Pashaki Darul Uloom,0,2,1578,2839,4419
16,1601,1601003,مکتب ابتدائیه ذکور کشتکی,Koshtaki Boys Primary School,0,0,585,770,1355
16,1601,1601004,مکتب متوسطه ذکور دیوه,Dewa Boys Secondary School,0,0,627,580,1207
16,1601,1601005,متوسطه ذکور پرونز,Pronz Boys Secondary School,0,0,265,366,631
16,1601,1601006,مکتب سابقه نسوان شتوی,Old Shetawi Girls School,0,0,802,848,1650
16,1601,1601010,مکتب ابتدائیه کوشت,Kosht Primary School,0,0,281,565,846
16,1602,1602011,مسجدشینگل,Shingal Mosque,0,0,699,1573,2272
16,1602,1602012,مکتب متوسطه وانت,Want Secondary School,0,0,1164,2589,3753
16,1602,1602022,مسجد زلیکان,Zalikan Mosque,0,0,1758,1755,3513
16,1603,1603026,پونز ابتدائیه مکتب,Poonz Primary School,0,0,316,555,871
16,1603,1603027,مسجد جامع کامګل,Kaam Gul Jami Mosque,0,1,488,318,807
16,1603,1603029,مسجد جامع سرپل,Sar Pul Jami Mosque,0,0,409,672,1081
16,1603,1603030,مکتب واما قدیم,Old Wama School,0,7,229,631,867
16,1603,1603031,جامع مسجد قریه ارچڼو,Archanno Village Jami Mosque,0,2,1659,2097,3758
16,1603,1603032,مکتب قریه کوردر,Kordar Village Mosque,0,0,393,870,1263
16,1604,1604033,مکتب متوسطه ملیل و مشقه,Malil wa Mashqa Secondary School,0,2,107,440,549
16,1604,1604034,مکتب متوسطه تیتت,Titin Secondary School,0,2,733,1122,1857
16,1604,1604035,مسجد جامع قریه ګده لام,Gadalam Village Jami Mosque,0,0,125,338,463
16,1604,1604036,مکتب کلت,Culton School,0,1,298,342,641
16,1604,1604037,شامه,Shaama,0,1,578,1223,1802
16,1604,1604039,ملک ومشوک,Malak wa Mashook,0,1,487,1148,1636
16,1604,1604040,مکتب متوسطه ودهو,Wadho Secondary School,0,0,83,337,420
16,1604,1604041,لیسه عالی ننګراج,Nangaraj High School,0,1,158,674,833
16,1604,1604038,کلینیک صحی پشګر,Pashgar Health Clinic,0,0,401,1635,2036
16,1605,1605042,مکتب متوسطه کور ګل,Kor Gul Secondary School,0,0,101,396,497
16,1605,1605043,لیسه عالی دوآب,Do Aab High School,0,1,269,1174,1444
16,1605,1605044,مسجد شاه دیس,Shah Dis Mosque,0,5,1205,3150,4360
16,1605,1605049,مکتب ژونیا,Jhonia School,0,5,13,293,311
16,1606,1606051,مکتب کامز آباد,Kaamiz Abad School,0,3,878,1158,2039
16,1606,1606052,کلینیک اکت اباد,Akbar Abad Clinic,0,2,981,2027,3010
16,1606,1606059,مسجد جامع قریه پتستان,Papristan Village Jami Mosque,0,0,312,543,855
16,1606,1606060,مکتب قریه کامدیش,Kamdesh Village School,0,0,404,495,899
16,1608,1608073,خانه ملک قریه شدګل,Shadgul Village Malik House,0,0,88,0,88
16,1608,1608076,مکتب قریه پشاورک,Peshawrak Village School,0,0,555,751,1306
16,1608,1608077,مسجد قریه انات,Anaati Village Mosque,0,0,1082,1088,2170
16,1608,1608078,ګنجلوک شال,Ganjlook Shaal,0,1,547,1123,1671
16,1608,1608079,مسجد جامع قریه پسیگرام,Pasigram Village Jami Mosque,0,1,443,563,1007
16,1608,1608074,مکتب قریه برگ متال غرب,Bargi Matal Gharb Village School,0,0,1241,1483,2724
16,1608,1608075,خانه ملک قریه افسی,Aafsi Village Malak House,0,0,589,907,1496
17,1701,1701001,تعمت کهنه لیسه عالی مخف,Makhfi High School Old Building,0,1,708,936,1645
17,1701,1701002,لیسه عالی مخف,Makhfi High School,0,1,380,596,977
17,1701,1701003,مسجد جامع اتفاق,Itifaq Jami Mosque,0,2,718,1763,2483
17,1701,1701004,لیسه نسوان نمت ۲,Girls High School No.2,0,1,957,557,1515
17,1701,1701005,لیسه عالی کوکچه,Kokcha High School,0,0,543,725,1268
17,1701,1701006,مکتب نجیب الله شهید,Najibullah Shaheed School,0,0,646,602,1248
17,1701,1701007,لیسه سایف شهید,Saayef Shaheed High School,0,1,1322,3000,4323
17,1701,1701008,لیسه نسوان سنگ مهر,Sang Mohar Girls High School,0,3,2812,2630,5445
17,1701,1701009,لیسه نسوان الجهاد,Aljihad Girls High School,0,0,988,642,1630
17,1701,1701010,لیسه ذک ور تجربوی الجهاد,Aljihad Tajrabawi Boys High School,0,5,571,1764,2340
17,1701,1701011,مکتب شور ابک,Shor Abak School,0,0,346,225,571
17,1701,1701012,مکتب گزان,Gazan School,0,0,100,141,241
17,1701,1701013,مکتب کول گهی,Kol Gahee School,0,0,82,150,232
17,1701,1701014,مکتب پلنگ دره,Palang Dara School,0,0,142,263,405
17,1701,1701015,مکتب نغز دره,Naghz Dara School,0,0,0,211,211
17,1701,1701016,مکتب دی گه,Dega School,0,0,4,134,138
17,1701,1701017,مکتب دره کولان,Dara Kolan School,0,0,94,152,246
17,1701,1701018,مکتب سر قول,Sar Qool School,0,1,140,225,366
17,1701,1701019,لیسه ضیاءالدین شهید,Ziauddin Shaheed High School,0,0,403,520,923
17,1701,1701020,لیسه نسوان لایابه,Layaba Girls High School,0,0,297,263,560
17,1701,1701021,مکتب ده کلان,Deh Kalan School,0,0,212,417,629
17,1701,1701022,لیسه تلتنگ,Talbazang High School,0,0,56,141,197
17,1701,1701023,مکتب دو ابه,Do Aaba School,0,0,2,236,238
17,1701,1701059,مکتب فیض شهید,Faizi Shaheed School,0,0,231,437,668
17,1702,1702025,مکتب باغ مبارک,Bagh e Mobarak School,0,1,162,284,447
17,1702,1702027,لیسه چتاق,Chatraq High School,0,1,296,277,574
17,1702,1702028,مسجد چک عبدل,Chak Abdul Mosque,0,0,93,155,248
17,1702,1702029,مکتب برلاس وخیان,Barlas Wakhian School,0,0,206,522,728
17,1702,1702030,مکتب ابتدائیه ارگتال,Argtaal Primary School,0,0,500,463,963
17,1702,1702031,مکتب ابتدائیه دره چرک,Dara Chark Primary School,0,0,271,308,579
17,1702,1702033,مکتب نسوان ده دهی,Deh Dehi Girls School,0,0,1047,1511,2558
17,1702,1702034,مکتب ابتدائیه قلعه دره,Qala Dara Primary School,0,0,50,504,554
17,1702,1702035,مسجد جامع خوش خم,Khosh Kham Jami Mosque,0,0,255,439,694
17,1702,1702036,مکتب متوسطه آب باریک,Aab Barik Secondary School,0,0,188,716,904
17,1702,1702037,مکتب برلاس شمر,Barlas Shamar School,0,2,457,368,827
17,1702,1702038,مکتب برلاس چنار,Barlas Chenar School,0,0,505,690,1195
17,1702,1702039,مکتب متوسطه خوش دره,Khosh Dara Secondary School,0,0,21,233,254
17,1702,1702040,کلینیک شتک,Shatak Clinik,0,1,96,390,487
17,1702,1702041,مکتب بوین قره,Boynee Qara School,0,1,285,1206,1492
17,1702,1702042,لیسه ذک ور خردمند شهید,Kheradmand Shaheed Boys High School,0,1,1123,1127,2251
17,1702,1702043,مکتب متوسطه گنده چشمه,Ganda Chashma Secondary School,0,1,561,668,1230
17,1702,1702044,مکتب یرنشه,Yaransha School,0,0,69,304,373
17,1702,1702045,لیسه نسوان سید عبدالکریم حسین,Sayed Abdul Karim Husaini Girls High School,0,0,1225,1334,2559
17,1702,1702046,مکتب خواجه ایشتل,Khwaja Eshtal School,0,2,649,391,1042
17,1702,1702047,مکتب متوسطه ارغند,Arghan Secondary School,0,1,799,1232,2032
17,1702,1702048,مسجدتوروق,Toroq Mosque,0,0,8,498,506
17,1702,1702049,لیسه شهباز خان شهید,Shahbaz Khan Shahid High School,0,0,684,580,1264
17,1702,1702050,لیسه ایتارچ,Etarchi High School,0,0,516,405,921
17,1702,1702051,مکتب صمدی,Samadi School,0,0,389,396,785
17,1702,1702052,مکتب لیسه کاکان,Kakan High School,0,0,329,442,771
17,1702,1702053,مکتب قره کمر,Qara Kamar School,0,1,173,364,538
17,1702,1702054,لیسه قچ,Qachi High School,0,0,269,465,734
17,1702,1702055,مکتب قدم,Qadam School,0,0,329,302,631
17,1702,1702056,لیسه عبدالقادر حنیف شهید,Abdul Qadir Hanif Shaheed High School,0,1,330,354,685
17,1702,1702032,مسجد جامع علی,Ali Jami Mosque,0,0,350,394,744
17,1702,1702057,مسجد قلعه ظفر,Qala Zafar Mosque,0,0,7,102,109
17,1703,1703058,مسجد خانقاه,Khanqa Mosque,0,1,133,199,333
17,1703,1703060,مکتب سمدره,Samdara School,0,2,173,348,523
17,1703,1703061,مکتب تگابک,Tagabak School,0,0,31,707,738
17,1703,1703062,مکتب سربلند,Sarboland School,0,0,352,773,1125
17,1703,1703065,مسجد خینج,Khinj Mosque,0,2,474,487,963
17,1704,1704066,مکتب لب دریا کوکچه ده ن سابات,Kokcha Riverside Dahan Sabat School,0,1,488,748,1237
17,1704,1704067,مسجد اروی شا,Arwisha Mosque,0,2,518,766,1286
17,1704,1704068,لیسه گزانک,Gazanak High School,0,3,379,937,1319
17,1704,1704069,مکتب سرن,Saran School,0,0,349,411,760
17,1704,1704070,لیسه ورینگ,Waring High School,0,0,270,480,750
17,1704,1704071,کلینیک نالند مرکز ولسوالی,District Center Naland Clinic,0,0,347,425,772
17,1704,1704072,لیسه اناث شکر لب,Shakarlab Girls High School,0,2,943,773,1718
17,1704,1704073,مکتب متوسطه پهندره,Pehandara Secondary School,0,1,737,815,1553
17,1704,1704074,مسجد والک,Walak Mosque,0,1,902,496,1399
17,1704,1704075,مکتب اناثت سپی,Speen Girls School,0,0,612,478,1090
17,1704,1704076,مکتب شلخزار,Shalkhzar School,0,0,473,398,871
17,1704,1704077,مکتب کشت گاه,Koshtgah School,0,0,601,769,1370
17,1704,1704078,لیسه بید کلان,Beed Kalan School,0,0,748,893,1641
17,1704,1704079,مکتب کشی دره,Kashin Dara School,0,0,403,539,942
17,1704,1704080,مکتب زمستانک,Zamistanak School,0,6,458,694,1158
17,1704,1704081,مکتب اناردره,Anar Dara School,0,0,1113,1049,2162
17,1704,1704082,مکتب فرغامبول,Farghambol School,0,1,755,844,1600
17,1705,1705083,لیسه نسوان سر لوله,Sar Lola Girls High School,0,0,613,818,1431
17,1705,1705084,لیسه غلام احمد,Ghulam Ahmad High School,0,0,625,940,1565
17,1705,1705085,لیسه نسوان عصمن,Asmati Girls High School,0,8,568,848,1424
17,1705,1705086,مکتب نسوان شاهان شهران,Shahan Shahran Girls High School,0,0,709,1103,1812
17,1705,1705087,لیسه نسوان تاجکان,Tajikan Girls High School,0,1,490,749,1240
17,1705,1705088,مکتب متوسطه درخ ان,Door Khan Secondary School,0,0,604,1258,1862
17,1706,1706089,مدرسه شهرنو,Shahr-i-Naw Madrasa,0,0,835,1230,2065
17,1706,1706090,مکتب چبچ یردار,Chabchi Yardar School,0,2,201,937,1140
17,1706,1706091,مکتب دشت فراخ,Dasht-i-Farakh School,0,2,1048,1377,2427
17,1706,1706092,مکتب یردار,Yardad School,0,0,248,683,931
17,1706,1706094,مکتب ملنگ اب,Malang Aab School,0,0,493,852,1345
17,1706,1706095,لیسه بهارستان,Baharistan High School,0,0,640,655,1295
17,1706,1706096,تعمت همبستگ دو آب,Hambastagi Do Aab Building,0,0,421,431,852
17,1706,1706097,لیسه نسوان خت آباد,Khair Abad Girls High School,0,2,597,855,1454
17,1706,1706098,مکتب فرمراغ,Farmaragh School,0,0,160,396,556
17,1706,1706099,مکتب پایان شهر,Payaan Shahr School,0,0,245,558,803
17,1706,1706100,مکتب آریان,Aryaan School,0,0,239,391,630
17,1706,1706093,مکتب علی مغل,Ali Moghol School,0,26,275,430,731
17,1707,1707101,لیسه دو آب منچ,Do Aab Manji High School,0,1,682,774,1457
17,1707,1707102,لیسه عارفان,Aarifan High School,0,0,763,804,1567
17,1707,1707104,لیسه دوآب ه مغل تای,Do Aaba Moghal Tai High School,0,0,1349,1160,2509
17,1707,1707105,مسجد جامع قریش,Quraishi Jami Mosque,0,1,257,359,617
17,1707,1707106,مکتب متوسطه دره باغ,Dara Bagh Secondary School,0,0,163,297,460
17,1707,1707107,مسجد جامع نیم تله,Neem Tala Jami Mosque,0,0,257,717,974
17,1707,1707108,مدرسه النعمان,al-Numan Madrasa,0,1,447,1030,1478
17,1707,1707109,لیسه عالی مدینه,Madina High School,0,0,633,910,1543
17,1707,1707110,مسجد جامع قریه چپه,Qarya Chapa Jami Mosque,0,1,870,794,1665
17,1707,1707111,لیسه نسوان شهر سعادت,Shahr-i-Sadat Girls High School,0,0,913,739,1652
17,1707,1707112,لیسه پنگاب,Pangani High School,0,1,1260,986,2247
17,1708,1708117,لیسه پس پل,Pas Pul High School,0,2,43,597,642
17,1708,1708118,مسجد شپوی بالا,Shapo-i-Bala Mosque,0,0,5,277,282
17,1708,1708119,مسجد زرنود,Zarnood Mosque,0,0,56,253,309
17,1708,1708120,مکتب وخن ده,Wakhti Deh Mosque,0,0,574,1221,1795
17,1709,1709121,مسجد آب زمچ,Aab Zamach Mosque,0,1,218,695,914
17,1709,1709122,مکتب پیتاو,Petaw School,0,1,367,1076,1444
17,1709,1709123,مکتب زو,Zoo School,0,0,292,498,790
17,1709,1709124,مکتب قطار بید پایان,Qatar Bid Payan School,0,0,338,554,892
17,1709,1709125,سنگ پایان,Sang Payaan,0,3,625,914,1542
17,1709,1709127,مسجدتنگان,Tangan Mosque,0,0,291,650,941
17,1709,1709128,مکتب ساری,Saari School,0,1,244,698,943
17,1709,1709129,مکتب متل دشت,Manzil Dasht School,0,0,407,503,910
17,1709,1709130,مدرسه تت گران,Teer Garan School,0,0,195,281,476
17,1709,1709131,مکتب شینگان پایان,Shingan Payan School,0,0,528,812,1340
17,1709,1709132,مسجد جامع افچ,Afach Jami Mosque,0,1,275,449,725
17,1709,1709133,مسجد روی رزا,Roy Raza Mosque,0,0,340,530,870
17,1709,1709134,مکتب ریمان,Reeman School,0,1,92,341,434
17,1709,1709126,مکتب یاوان,Yawan School,0,0,437,649,1086
17,1710,1710135,لیسه غیاب,Ghayasee High School,0,0,1236,2051,3287
17,1710,1710136,لیسه غلام محمد خر انداب,Ghulam Mohammad Khar Andab High School,0,2,689,1458,2149
17,1710,1710137,نسوان خرنداب,Kharandab Girls School,0,0,510,986,1496
17,1710,1710138,لیسه سوچ,Sooch High School,0,0,165,410,575
17,1710,1710139,لیسه فرغا متو,Fargha Mero High School,0,0,979,1227,2206
17,1710,1710146,لیسه کتیب,Kateeb High School,0,1,663,1121,1785
17,1710,1710149,لیسه نو جرم و چنگ ها,Naw Jurm and Changha High School,0,0,898,1202,2100
17,1711,1711151,مکتب ده آستایان,Deh Astayan School,0,0,42,296,338
17,1711,1711153,مکتب ده سیدان,Deh Saydan School,0,0,1098,1210,2308
17,1711,1711154,مکتب یاولی بالا,Yawli Bala School,0,0,382,451,833
17,1711,1711155,مکتب ارغندکان,Arghandkan School,0,1,511,883,1395
17,1711,1711156,مکتب دشت آغه,Dasht Agha School,0,0,435,451,886
17,1711,1711157,مکتب بازار تیشکان,Bazaar Teshakan School,0,0,626,1044,1670
17,1711,1711158,مکتب حضت عباس,Hazrat Abas School,0,0,313,438,751
17,1711,1711159,مکتب سیدان,Saydan School,0,1,343,731,1075
17,1711,1711160,مکتب پسته خور,Pesta Khor School,0,1,859,940,1800
17,1711,1711161,مکتب مظفری,Muzafari School,0,0,486,440,926
17,1712,1712162,مکتب محمودان,Mahmodan School,0,3,748,849,1600
17,1712,1712163,مکتب ابو طلحه,Abu Talha School,0,1,740,835,1576
17,1712,1712164,مکتب شمس الحق,Shamsulhaq School,0,0,591,624,1215
17,1712,1712165,لیسه زین الدین شهید,Zainuddin Shaheed High School,0,1,506,639,1146
17,1712,1712166,مکتب حامدی,Hamidi School,0,0,435,457,892
17,1712,1712167,مکتب وکیل عبدالجبار,Wakil Abdul Jabar School,0,1,428,505,934
17,1712,1712168,مکتب ایزرو,Ezro School,0,1,389,526,916
17,1712,1712169,مکتب متوسطه محمد رحیم,Mohammad Rahim Secondary School,0,1,416,599,1016
17,1713,1713170,لیسه برلاس,Barlas High School,0,0,154,94,248
17,1713,1713171,لیسه کول,Kol High School,0,1,938,766,1705
17,1713,1713172,مکتب متوسطه دشت فرنگ,Dasht Farang Secondary School,0,1,487,530,1018
17,1713,1713173,مکتب ملوان,Malwan School,0,0,447,510,957
17,1713,1713174,مکتب شیخان,Shekhan School,0,0,287,327,614
17,1713,1713175,لیسه خوردکان,Khordakan High School,0,0,1000,987,1987
17,1713,1713176,مسجد بلبل دره,Balbal Dara Mosque,0,0,5,161,166
17,1713,1713177,باری خم,Bari Khom,0,0,635,469,1104
17,1713,1713178,مکتب کره مابی,Karabin School,0,0,303,343,646
17,1713,1713179,لیسه چوگاب,Chogani High School,0,1,231,833,1065
17,1713,1713180,مسجد غضنفر پائی,Gazanfar Payeen Mosque,0,0,68,256,324
17,1713,1713181,مکتب وندیان,Wandian School,0,0,469,883,1352
17,1713,1713182,مکتب متوسطه آب گنده,Aab Ganda Secondary School,0,0,40,1034,1074
17,1713,1713183,مکتب اسپاه خواه,Aspa Khwa School,0,0,78,188,266
17,1713,1713184,مکتب دره کلاب,Dara Kalati School,0,0,19,233,252
17,1713,1713185,مکتب سنگ خواه,Sangi Khwa School,0,0,316,218,534
17,1714,1714186,مکتب متوسطه نقش ده,Naqsh Deh Secondary School,0,1,214,1575,1790
17,1714,1714187,مسجد زیرگ,Zeeraki Mosque,0,2,243,2245,2490
17,1714,1714192,مکتب علیا خم,Olia Khom School,0,1,307,1318,1626
17,1714,1714193,مکتب پتت,Pateer School,0,0,120,1071,1191
17,1715,1715195,مکتب نسوان مشهد,Mashhad Girls School,0,1,737,2528,3266
17,1715,1715196,درال علوم عبدالله ابن عباس,Darul Uloom Abdullah Ibn Abbas,0,3,1021,1409,2433
17,1715,1715197,مکتب قره بلا,Qara Bala School,0,0,328,581,909
17,1715,1715198,مکتب پشه دره,Pasha Dara School,0,5,196,246,447
17,1715,1715199,مکتب خشکه دره,Khoshka Dara School,0,7,744,970,1721
17,1715,1715200,مکتب نمازگاه,Namazgah School,0,1,1716,1659,3376
17,1715,1715202,مسجد جامع حضت سرور کاینات,Hazrat Sarwar Kayenat Jami Mosque,0,10,1816,1839,3665
17,1715,1715203,مکتب نسوان جر شاه بابا,Jar Shah Baba Girls School,0,23,572,598,1193
17,1715,1715204,مکتب دشت خاورک,Dashti Khawrak School,0,2,238,607,847
17,1715,1715205,مکتب سنگاب,Sangaab School,0,2,545,652,1199
17,1715,1715206,مکتب خمبک,Khambak School,0,0,191,322,513
17,1715,1715207,مکتب چارمغ,Charmagh School,0,0,803,808,1611
17,1715,1715208,مکتب نوآباد گندم قول,Nawabad Gandom Qol School,0,1,913,845,1759
17,1715,1715209,مکتب وخش,Wakhshi School,0,0,402,469,871
17,1715,1715210,مکتب گندن قول,Gandan Qol School,0,0,1425,1829,3254
17,1715,1715211,مسجد حضت بلال,Hazrat Bilal Mosque,0,7,654,634,1295
17,1715,1715212,لیسه تکیه,Takia High School,0,0,454,864,1318
17,1715,1715213,لیسه محزون بلوچ,Mahzoon Baloch High School,0,20,836,1747,2603
17,1715,1715214,مکتب نوچ,Nochi School,0,1,630,323,954
17,1715,1715201,مکتب دره جیم,Dara Jeem School,0,7,822,1174,2003
17,1717,1717226,مکتب خمبک بالا,Khambak Bala School,0,0,193,204,397
17,1717,1717227,مسجد ارغنج خواه,Arghanj Khwa Mosque,0,0,0,2,2
17,1717,1717228,مسجد دو آب,Do Aabi Mosque,0,0,2,3,5
17,1717,1717229,مکتب کوری,Kori School,0,0,186,521,707
17,1717,1717230,مسجد عاجل,Aajil Mosque,0,0,73,120,193
17,1717,1717231,مکتب آسیابک,Asiabak School,0,0,442,660,1102
17,1717,1717232,مکتب ست دره,Sabz Dara School,0,12,392,718,1122
17,1717,1717234,مکتب کرسده,Karsada School,0,0,798,901,1699
17,1717,1717233,مکتب فرمان قلی,Farman Qoli School,0,0,457,942,1399
17,1719,1719246,مکتب درمارخت,Darmarakht School,0,0,440,418,858
17,1719,1719247,مکتب پستیو غار جوین,Pastio Ghar Joyan School,0,0,133,147,280
17,1719,1719248,مکتب ذک ور ویر,Weer Boys School,0,0,399,403,802
17,1719,1719249,لیسه رح مت,Rahmat High School,0,3,780,710,1493
17,1719,1719250,لیسه سر چشمه,Sarchashma High School,0,0,535,512,1047
17,1719,1719251,لیسه شدوج,Shadoj High School,0,1,772,614,1387
17,1719,1719252,لیسه چاسنور علیا,Chasnor Olia High School,0,0,161,165,326
17,1719,1719253,مکتب پاجور چاوید,Pajor Chawid School,0,0,354,282,636
17,1719,1719254,مسجد یارخ,Yarokh Mosque,0,0,274,252,526
17,1720,1720255,مکتب سیل دان,Sayl Dadan School,0,0,978,1297,2275
17,1720,1720256,مکتب حوض شاه,Hawz Shah School,0,0,196,835,1031
17,1720,1720257,مکتب حوزه شاه,Hawza Shah School,0,0,408,0,408
17,1720,1720258,مکتب روی ن زار,Royan Zar School,0,0,212,245,457
17,1720,1720259,مسجد جر پایان,Jar Payaan Mosque,0,0,109,163,272
17,1720,1720260,لیسه ذک ور چشمه توت,Chashma Toot High School,0,2,795,1009,1806
17,1720,1720261,مکتب ته کمر,Tehkamar School,0,0,240,238,478
17,1721,1721262,مکتب پای مزار,Pay Mazar School,0,1,676,1312,1989
17,1721,1721263,مکتب شخرو,Shakhro School,0,0,591,691,1282
17,1721,1721264,مکتب کرنیو,Karneo School,0,2,656,955,1613
17,1721,1721265,مکتب پدیو,Padio School,0,4,288,377,669
17,1721,1721266,مکتب نشهر,Nashhar School,0,0,539,520,1059
17,1721,1721267,مکتب قلعه,Qala School,0,0,802,793,1595
17,1722,1722268,مکتب تنگ شیو,Tang Shew School,0,6,92,243,341
17,1722,1722270,مکتب جامرچ,Jamarch School,0,0,705,519,1224
17,1722,1722271,مکتب چاشتک,Chashtak School,0,0,630,466,1096
17,1722,1722272,مکتب ورفد,Warfad School,0,0,463,458,921
17,1722,1722273,مدرسه چار باغ,Charbagh Madrasa,0,0,1680,1449,3129
17,1722,1722274,مکتب وروه,Warwa School,0,1,381,345,727
17,1722,1722269,مکتب غمی,Ghami School,0,0,286,289,575
17,1723,1723275,لیسه بازگت,Baazgeer High School,0,0,261,205,466
17,1723,1723276,مکتب خوش پاک,Khospak School,0,1,291,298,590
17,1723,1723277,لیسه اشکاشم,Ashkasham High School,0,2,890,1228,2120
17,1723,1723278,مکتب لیسه کندکاد,Kandkad High School,0,0,268,291,559
17,1723,1723279,مکتب یخدرو,Yakhdaro School,0,16,293,295,604
17,1723,1723280,مکتب زی چ,Zeech School,0,0,188,195,383
17,1723,1723281,مکتب لیسه غاران بلا,Gharan Bala High School,0,2,152,170,324
17,1723,1723282,مکتب گل باغ,Gul Bagh School,0,0,124,126,250
17,1724,1724283,لیسه مشتوها,Mashtoha High School,0,0,154,140,294
17,1724,1724285,مکتب خان دره,Khan Dara School,0,1,205,184,390
17,1724,1724286,مکتب لیسه ماه نو,Mah-e-Naw High School,0,0,481,517,998
17,1724,1724287,مکتب غمی,Ghami School,0,0,357,208,565
17,1724,1724288,لیسه ژرف,Jarf High School,0,0,411,314,725
17,1724,1724289,مکتب سر ناظم,Sar Nazim School,0,0,466,288,754
17,1724,1724290,مکتب عالی شهر ست,Shahri Sabz School,0,1,406,330,737
17,1724,1724291,لیسه نسوان اوب غن سفلی,Obghan Sofla Girls High School,0,0,167,187,354
17,1724,1724284,مکتب ابتدائیه سنگ لیچ,Sanglich Primary School,0,0,546,504,1050
17,1725,1725292,لیسه فاروق,Farooq High School,0,0,281,307,588
17,1725,1725293,لیسه نسوان زیباک,Zeebak Girls High School,0,0,526,534,1060
17,1725,1725294,مکتب دند قریه دند,Qarya Dand School,0,0,401,365,766
17,1725,1725295,مکتب عاشور بیک,Aashor Bek School,0,0,256,281,537
17,1726,1726296,مکتب حبیب الرحمن شهید,Habib-ur-Rahman Shaheed School,0,0,205,354,559
17,1726,1726297,مکتب ده ن آب یمک,Dahan Aab Yamak School,0,0,45,304,349
17,1726,1726298,کلینیک اسکازر,Askazar Clinic,0,1,269,369,639
17,1726,1726299,کلینک رازر,Razar Clinic,0,1,181,251,433
17,1726,1726300,مکتب شاهی پری,Shahi Pari School,0,2,308,547,857
17,1726,1726301,کلینیک شهران,Shahran Clinic,0,0,130,261,391
17,1726,1726302,مکتب لاجور شو,Lajor Sho School,0,0,41,230,271
17,1727,1727303,لیسه سر جوی,Sar Joy High School,0,0,325,259,584
17,1727,1727304,مکتب مگ,Maggi School,0,2,277,257,536
17,1727,1727305,مکتب مه گ جاوای,Mah-gi Jaway School,0,0,180,169,349
17,1727,1727306,مدرسه خرکد,Kharkad School,0,0,253,216,469
17,1727,1727307,مکتب سرپل,Sari Pul School,0,0,520,515,1035
17,1727,1727308,مکتب آرون,Aaron School,0,0,282,367,649
17,1727,1727309,لیسه دوآب شوریان,Do Aab Shorian High School,0,1,187,303,491
17,1727,1727310,مکتب زوغ ار,Zoghar School,0,1,488,424,913
17,1727,1727311,مکتب اوباغون,Obaghoon School,0,1,543,427,971
17,1727,1727312,لیسه نش,Nasi High School,0,3,356,358,717
17,1728,1728313,مکتب قاض ده,Qazi Deh School,0,0,342,350,692
17,1728,1728314,مکتب شخور,Shakhor School,0,0,200,202,402
17,1728,1728315,لنگر,Langar,0,0,140,137,277
17,1728,1728316,مکتب خندود,Khandood School,0,0,391,359,750
17,1728,1728317,لیسه پنجه,Panja High School,0,1,194,234,429
17,1728,1728318,مکتب متوسطه سست,Sast Secondary School,0,0,12,133,145
17,1728,1728319,مکتب متوسطه کیپ کوت,Kip Kot Secondary School,0,0,320,397,717
17,1728,1728320,مکتب متوسطه نیشت خور,Nesht Khor Secondary School,0,0,288,311,599
17,1728,1728321,سرحد پامت_لیسه پتوخ,Sarhad Pamir_Patokh High School,0,2,141,310,453
18,1801,1801001,لیسه ذک ور ابو عثمان,Abo Osman Boys High School,0,3,1325,2091,3419
18,1801,1801002,مسجد جامع امام ابو حنیفه,Imam Abu Hanifa Jami Mosque,0,0,1151,1068,2219
18,1801,1801003,مکتب عبدالباری شهید,Abdul Bari Shaheed School,0,1,1042,963,2006
18,1801,1801004,ریاست معدن,Mine Directorate,0,0,1017,942,1959
18,1801,1801005,مسجد جامع ابراهیم خلیل الله,Ibrahim Khalilullah Jami Mosque,0,3,877,680,1560
18,1801,1801006,مکتب ابتدای بولک اورته بز,Bolak Orta Baz Primary School,0,0,563,668,1231
18,1801,1801008,لیسه ذک ور سید عبدالله,Sayed Abdullah Boys High School,0,1,1477,2327,3805
18,1801,1801009,مکتب عبدالاول قریش,Abdul Awal Quraishi School,0,0,502,570,1072
18,1801,1801010,مكتب ابتدائيه باغك,Baghak Primary School,0,1,1048,1307,2356
18,1801,1801011,مسجدپیمحمدخاکسار,Peer Mohammad Khaksar Mosque,0,0,809,1248,2057
18,1801,1801012,لیسه داکی سید حسی,Doctor Sayed Husain High School,0,0,1154,2108,3262
18,1801,1801013,ریاست اطلاعات وفرهنگ,Information and Culture Directorate,0,0,394,1014,1408
18,1801,1801014,لیسه خطايان,Khatayan High School,0,0,721,880,1601
18,1801,1801015,لیسه لته بند,Lata Band High School,0,0,323,304,627
18,1801,1801016,لیسه ب ب مریم,Bibi Maryam High School,0,1,1094,950,2045
18,1801,1801017,لیسه ملا عبدالودود,Mullah Abdul Wadod High School,0,4,2035,2807,4846
18,1801,1801018,ليسه چشمه شی,Chashma Sheer High School,0,17,817,1072,1906
18,1801,1801019,مدرسه تخته کوپرک,Takhta Koprak Madrasa,0,2,177,420,599
18,1801,1801020,لیسه آق مسجد,Aaq Masjid High School,0,5,953,1473,2431
18,1801,1801021,لیسه گل نظر,Gul Nazar High School,0,1,873,1036,1910
18,1801,1801022,ليسه عبدالطيف شهيد,Abdul Latif Shaheed High School,0,0,289,378,667
18,1801,1801023,مکتب چییه ب,Chenzayee School,0,2,286,513,801
18,1801,1801024,مکتب شورچه 2,Shorcha 2 School,0,0,173,143,316
18,1801,1801025,لیسه نهر سعید,Nahri Saeed High School,0,0,398,745,1143
18,1801,1801026,لیسه فیاض شهید,Fayaz Shaheed High School,0,2,909,1505,2416
18,1801,1801027,مکتب انجی نیک محمد,Engineer Nek Mohammad School,0,0,344,703,1047
18,1801,1801028,مکتب جوی شیخ,Joy Shekh School,0,0,165,253,418
18,1801,1801029,لیسه تودان,Todan High School,0,0,415,405,820
18,1801,1801030,مکتب الفاروق,Alfaroq School,0,0,979,1369,2348
18,1801,1801031,ليسه آهن دره,Ahan Dara High School,0,1,1128,1173,2302
18,1801,1801032,ليسه گنج علی بیگ,Ganj Ali Beg High School,0,1,914,987,1902
18,1801,1801033,مکتب شورچه 1,Shorcha 1 School,0,0,489,484,973
18,1801,1801034,مکتب خواجه خلیل,Khwaja Khalil School,0,0,0,1123,1123
18,1801,1801035,مکتب اوچقدق,Awchaqdaq School,0,0,467,665,1132
18,1801,1801036,مکتب ترمه باب,Tarma Babi School,0,0,285,487,772
18,1801,1801037,لیسه قاری صدیق,Qari Sediq High School,0,3,570,955,1528
18,1801,1801038,لیسه سرای سنگ,Saray Sang High School,0,4,1260,1520,2784
18,1801,1801039,لیسه عبدالرحمن تالقاب,Abdul Rahman Taloqani High School,0,0,444,596,1040
18,1801,1801007,ریاست زراعت,Agriculture Directorate,0,1,761,1126,1888
18,1802,1802040,مکتب متوسطه آق مسجد,Aaq Masjid Secondary School,0,0,579,657,1236
18,1802,1802041,مسجد خواجه لمتو,Khwaja Lamto Mosque,0,2,1086,1091,2179
18,1802,1802042,مکتب قلعه مامه ب,Qala Mamayee School,0,0,403,425,828
18,1802,1802043,مکتب ابتدائیه اچه,Achah Primary School,0,0,585,717,1302
18,1802,1802044,مکتب متوسطه ب ب خدیجه,Bibi Khadija Secondary School,0,0,263,281,544
18,1802,1802045,مکتب متوسطه هزارسموچ,Hazar Samoch Secondary School,0,1,447,541,989
18,1803,1803046,مکتب شور قدوق,Shor Qadoq School,0,1,1755,1678,3434
18,1803,1803047,مکتب قزل سای,Qazal Say School,0,0,691,648,1339
18,1803,1803048,لیسه حاج پهلوان,Haji Pahlawan High School,0,3,312,598,913
18,1803,1803049,مکتب ابتدائیه غلام سرور شهید,Ghulam Sarwar Shaheed Primary School,0,0,781,748,1529
18,1803,1803050,لیسه الحاج عبدالقیوم بیک,Alhaj Abdul Qayum Bek High School,0,0,1112,1356,2468
18,1803,1803051,مکتب ابتدائیه چاپله,Chapla Primary School,0,0,746,777,1523
18,1803,1803052,لیسه قاض عنایت الله,Qazi Enayatullah High School,0,0,323,301,624
18,1803,1803053,مکتب ابتدائیه حضت عمر,Hazrat Omar Primary School,0,3,579,714,1296
18,1803,1803054,مسجد حسن نورعلی,Hassan Noor Ali Mosque,0,2,381,266,649
18,1804,1804055,لیسه چارچنار,Char Chinar High School,0,1,1553,1139,2693
18,1804,1804056,مکتب میمحمد داود شهید,Mir Mohammad Dawood Shaheed School,0,1,1133,1072,2206
18,1804,1804057,لیسه منصورشهید,Mansoor Shaheed High School,0,0,806,946,1752
18,1804,1804058,مکتب غریچ,Gharichi School,0,0,117,286,403
18,1804,1804059,لیسه نسوان آفاق,Aafaqi Girls High School,0,0,1009,1207,2216
18,1804,1804060,لیسه قلیاق,Qolbaraq High School,0,1,756,659,1416
18,1804,1804061,مسجدجامع بورکه خورد,Borka Khord Jami Mosque,0,0,169,194,363
18,1804,1804062,مکتب دهانه بنگ,Dahana Bang School,0,0,451,459,910
18,1804,1804063,لیسه مولوی عزت الله شهید,Maulvi Ezatullah Shaheed High School,0,0,527,1152,1679
18,1804,1804064,مکتب دی ن محمد شهید,Din Mohammad Shaheed School,0,15,1266,1507,2788
18,1805,1805065,لیسه صیاد,Sayaad High School,0,0,692,654,1346
18,1805,1805066,مکتب سنگ لشم,Sangi Lashm School,0,0,530,554,1084
18,1805,1805067,لیسه سید نعمت الله,Sayed Nimatullah High School,0,0,868,849,1717
18,1805,1805068,لیسه سمنداب,Samandab High School,0,0,578,564,1142
18,1805,1805069,لیسه عبدالواحد شهید,Abdul Wahid Shaheed High School,0,0,254,262,516
18,1805,1805070,مکتب محمدعمرشهید,Mohammad Omar Shaheed School,0,0,301,398,699
18,1805,1805071,مسجد خواجه بنا,Khwaja Bana Mosque,0,0,595,861,1456
18,1805,1805242,مکتب متوسطه زولان دره,Zolandara Secondary School,0,0,270,223,493
18,1805,1805243,مکتب نقیب احمد شهید,Naqib Ahmad Shahid School,0,0,100,106,206
18,1805,1805244,مکتب متوسطه دره کلان,Dara Kalan Secondary School,0,0,367,324,691
18,1805,1805245,مکتب امام حسی,Emam Husain School,0,0,646,553,1199
18,1805,1805246,مکتب متوسطه چالو خورد,Chalo Khord Secondary School,0,0,618,566,1184
18,1806,1806075,مکتب صد برگان,Sad Bozorgan School,0,0,331,613,944
18,1806,1806076,مرکز ولسوالی,District Center,0,1,1049,1683,2733
18,1806,1806077,مکتب ابتدایه تاش یلاق,Tash Yalaq Primary School,0,0,267,261,528
18,1807,1807078,مکتب متوسطه حضت عثمان,Hazrat Osman Secondary School,0,1,502,283,786
18,1807,1807079,لیسه محمد حسی شهید,Mohammad Husain Shaheed High School,0,2,1597,1580,3179
18,1807,1807080,لیسه نسوان کلفگان,Kolfagan Girls High School,0,0,2134,1640,3774
18,1807,1807081,لیسه محمد سرور شهید,Mohammad Sarwar Shaheed High School,0,0,562,363,925
18,1807,1807082,لیسه حضت خالد,Hazrat Khalid High School,0,0,1601,932,2533
18,1807,1807083,مکتب ابتدایه گرم سی,Garamser Primary School,0,0,471,469,940
18,1807,1807084,مکتب متوسطه امام ابوحنیفه,Imam Abu Hanifa Secondary School,0,2,424,374,800
18,1807,1807085,مکتب متوسطۀ میحسی ناوان,Mir Hussain Nawan Secondary School,0,0,750,458,1208
18,1807,1807086,مکتب ابتدائه حضت امیم عاویه,Hazrat Amir Muawia Primary School,0,1,74,50,125
18,1807,1807087,مکتب ابتدائیه قرق ساي,Qaraq Say Primary School,0,0,464,430,894
18,1807,1807088,مکتب متوسطۀ گزستان,Gazistan Secondary School,0,0,676,553,1229
18,1807,1807089,لیسه ابوعبیده,Abu Obaida High School,0,0,966,694,1660
18,1807,1807090,متوسطه لب دریا کوکچه,Labi Darya Kokcha Secondary School,0,1,523,320,844
18,1808,1808091,مکتب مشتان,Moshtan School,0,0,594,590,1184
18,1808,1808092,مکتب یوخ,Yokh School,0,0,305,196,501
18,1808,1808093,ليسه لژده,Lajdah High School,0,0,1154,795,1949
18,1808,1808094,مکتب میاح مدی شهید,Mir Ahmadi Shaheed School,0,0,636,758,1394
18,1808,1808095,متوسطه قاض عبدالچ شهید,Qazi Abdul Hai Shaheed Secondary School,0,1,384,464,849
18,1808,1808096,لیسه قانعت شهید,Qinat Shaheed High School,0,0,411,428,839
18,1808,1808097,لیسه سید عبدالرحمن شهید,Sayed Abdul Rahman Shaheed High School,0,0,572,547,1119
18,1808,1808098,مکتب مخدوم عبدالله شهید,Makhdom Abdullah Shaheed School,0,0,519,321,840
18,1808,1808099,مکتب متوسطه کشکتان,Kashtakan Secondary School,0,0,531,410,941
18,1808,1808100,لیسه مولوی غلام رسول شهید,Maulvi Ghulam Rasool Shaheed High School,0,0,576,445,1021
18,1808,1808101,لیسه صمیمی شهید,Samimi Shaheed High School,0,0,2470,2211,4681
18,1808,1808102,لیسه محمد نت شهید,Mohammad Nabi Shaheed High School,0,0,1278,1174,2452
18,1808,1808103,چمن خسده,Chaman Khasdah,0,0,1682,1734,3416
18,1809,1809104,لیسه عاقله مامه ب,Aaqila Mamayee High School,0,0,1185,1103,2288
18,1809,1809112,مکتب صاف قروق,Saaf Qarooq School,0,237,191,241,669
18,1809,1809113,لیسه حسام الدین شهید,Husamuddin Shaheed High School,0,0,511,435,946
18,1809,1809114,لیسه غلام سچ,Ghulam Sakhi High School,0,0,1168,1162,2330
18,1809,1809115,مسجد دهنه قزل سای,Dahna Qazal Say Mosque,0,0,282,311,593
18,1809,1809116,مکتب ابتدائیه هموارسای,Hamwar Say Primary School,0,1,669,497,1167
18,1810,1810117,لیسه حضت عمرفاروق,Hazrat Omar Faroq High School,0,0,2536,3400,5936
18,1810,1810118,مکتب ابتدایه اتفاق نمی۲,Itifaq No.2 Primary School,0,0,176,220,396
18,1810,1810119,مسجد جامع قره بلاق,Qara Balaq Jami Mosque,0,2,312,248,562
18,1810,1810120,مسجد قدق تاجکان,Qodoq Tajikan Mosque,0,0,190,349,539
18,1810,1810121,مکتب متوسطه شیاتله,Sheratla Secondary School,0,0,409,600,1009
18,1810,1810122,لیسه خواجه علاوالدین,Khwaja Alauddin High School,0,0,847,848,1695
18,1810,1810123,مکتب ابتدائیه یامچ,Yamchi Primary School,0,1,496,580,1077
18,1810,1810124,مسجد شیخ سلمان,Shaikh Salman Mosque,0,0,91,253,344
18,1810,1810125,مکتب ابتدائیه نارستان,Naristan Primary School,0,0,181,189,370
18,1810,1810126,لیسه کوکتابه,Koktaba High School,0,0,434,661,1095
18,1810,1810127,مسجد قریه چنار,Qarya Chenar Mosque,0,0,168,392,560
18,1810,1810128,کلینیک قدق جوازخانه,Qodoq Jawazkhana Clinic,0,0,186,930,1116
18,1810,1810129,مکتب ابتدایه دشتک سفلا,Dashtak Sofla Primary School,0,0,188,220,408
18,1810,1810130,لیسه حضت عثمان,Hazrat Osman High School,0,0,285,420,705
18,1810,1810131,لیسه متوسطه ذک ور سیاب,Sayab Boys Secondary School,0,3,860,1208,2071
18,1810,1810132,لیسه نسوان شهر کهنه,Shahri Kohna Girls High School,0,0,1076,1477,2553
18,1810,1810133,مکتب متوسطه می ملا ولی,Mir Mulla Wali Secondary School,0,0,411,552,963
18,1810,1810134,لیسه حضت خلالی,Hazrat Khalali High School,0,0,490,738,1228
18,1810,1810135,مکتب متوسطه مولوی عبدالقدوس شه,Maulvi Abdul Qodos Shaheed Secondary School,0,0,541,د557,1098
18,1810,1810136,مکتب متوسطه خواجه خیاب,Khwaja Khairab Secondary School,0,0,245,367,612
18,1810,1810137,مکتب متوسطۀ چبدره وبتاش,Chabdara wa Batash Secondary School,0,0,242,489,731
18,1810,1810138,مکتب متوسطۀ آبزان,Aabzaan Secondary School,0,0,381,306,687
18,1810,1810139,مکتب متوسطۀ ابوهریره,Abu Horaira Secondary School,0,0,220,197,417
18,1810,1810140,لیسه مولانا جلال الدین,Maulan Jalaluddin High School,0,0,561,555,1116
18,1810,1810141,مسجد جامع,Jami Mosque,0,0,260,246,506
18,1810,1810142,مکتب متوسطه حضت بلال,Hazrat Bilal Secondary School,0,0,890,846,1736
18,1810,1810143,مکتب متوسطه سرغار,Sarghar Secondary School,0,0,362,821,1183
18,1810,1810144,مکتب متوسطه دشتک علیا,Dashtak Olia Secondary School,0,0,102,264,366
18,1810,1810145,مسجد جامع زان پایان,Zaan Payaan Jami Mosque,0,0,457,290,747
18,1810,1810146,مکتب متوسطه هرازسموج,Haraz Samoj Secondary School,0,0,415,0,415
18,1810,1810147,لیسه ابوالقاسم گرگاب,Abul Qasim Goragani High School,0,0,736,705,1441
18,1810,1810148,مسجد لنگر سادات,Langar Sadat Mosque,0,0,411,452,863
18,1810,1810149,مکتب توحید اسلامی,Tawhid-e-Islami School,0,0,512,435,947
18,1810,1810150,مکتب ابتدائیه فیض آباد,Faizabad Primary School,0,0,314,403,717
18,1810,1810151,مکتب متوسطه گنده,Ganda Secondary School,0,0,652,732,1384
18,1810,1810152,مکتب متوسطه تولکی وچپه خانه,Tolki wa Chapa Khana Secondary School,0,0,1254,1116,2370
18,1810,1810153,مکتب حضت اب ابن کعب,Hazrat Obai Ibn Ka'b School,0,0,785,905,1690
18,1810,1810154,متوسطه یکه توت سفلی,Yaka Toot Sofla Secondary School,0,0,192,330,522
18,1810,1810155,لیسه حضت عبدالله ابن مسعود,Hazrat Abdullah Ibn Massod High School,0,0,587,17,604
18,1810,1810156,مکتب متوسطه اتفاق نمی۱,Itifaq No.1 Secondary School,0,0,527,965,1492
18,1810,1810157,مکتب ابتدائیه قره دینگ,Qara Ding Primary School,0,0,426,352,778
18,1811,1811158,لیسه دهنه شیه,Dahna Sheera High School,0,1,584,588,1173
18,1811,1811159,مسجد سياه دره,Sia Dara Mosque,0,0,300,438,738
18,1811,1811160,مدرسه بادام دره,Badam Dara Madrasa,0,1,1175,580,1756
18,1811,1811161,مکتب لیسه نواباد,Naw Abad High School,0,1,460,533,994
18,1811,1811162,مکتب متوسطه قيی,Qinar Secondary School,0,0,1456,1297,2753
18,1811,1811163,مکتب ابتدائیه دره کلان,Dara Kalan Primary School,0,1,756,590,1347
18,1811,1811164,مکتب ابتدائیه آبرو,Aabro Primary School,0,0,388,899,1287
18,1811,1811165,لیسه طارق شهید,Tariq Shaheed High School,0,1,1133,1848,2982
18,1811,1811166,مکتب ابتدائیه باد گذر,Bad Guzar Primary School,0,0,840,1398,2238
18,1811,1811167,مسجد جامع قشلاق سای,Qeshlaq Say Jami Mosque,0,0,704,840,1544
18,1811,1811168,مسجد جامع بویرک,Boyrak Jami Mosque,0,2,1058,955,2015
18,1811,1811169,مکتب ابتدائیه ترسک,Tarsak Primary School,0,0,372,479,851
18,1811,1811247,مکتب دی ن محمد شهید,Din Muhammad Shahid School,0,2,1043,582,1627
18,1813,1813182,مکتب متوسطه احمدشاه مسعود شهید,Ahmad Shah Masood Shaheed Secondary School,0,0,216,223,439
18,1813,1813183,مکتب ابتدائیه پیو,Payo Primary School,0,0,426,355,781
18,1813,1813184,مکتب متوسطه مولوی محمد نظرشهید,Maulvi Mohammad Nazar Shaheed Secondary School,0,1,270,229,500
18,1813,1813185,مسجد جامع اسكوان,Askwan Jami Mosque,0,1,395,275,671
18,1813,1813186,لیسه انصاف شهید,Insaf Shaheed High School,0,0,903,67,970
18,1813,1813187,لیسه غلام حضت شهید,Ghulam Hazrat Shaheed High School,0,2,494,395,891
18,1813,1813188,لیسه پژک بالا,Pajak Bala High School,0,0,555,432,987
18,1813,1813189,لیسه ب ب ذینب,Bibi Zainab High School,0,0,703,732,1435
18,1813,1813190,لیسه سید ظهرالدین شهید,Sayed Zohruddin Shaheed High School,0,2,1389,1776,3167
18,1813,1813191,مکتب متوسطه شیخ نجم الدین,Shaikh Najmuddin Secondary School,0,0,223,161,384
18,1813,1813192,مکتب متوسطه پست آب,Past Aab Secondary School,0,1,1274,745,2020
18,1813,1813193,دارال علوم امام ابوحنیفه,Darul Uloom Imam Abu Hanifa,0,1,681,977,1659
18,1813,1813194,مکتب متوسطه ترشت,Tarasht Secondary School,0,1,1197,450,1648
18,1814,1814195,مکتب لاله گزر,Lala Guzar School,0,0,521,596,1117
18,1814,1814196,مکتب ابتدائیه عروق قشلاق,Aroq Qeshlaq Primary School,0,1,869,954,1824
18,1814,1814197,مکتب ابتدائیه لرخواب,Lar Khwabi Primary School,0,1,488,514,1003
18,1814,1814199,مکتب ابتدائیه ناحیه پنجم,Nahia 5 Primary School,0,0,431,408,839
18,1814,1814200,لیسه ذک ورخ واجه بهاوالدین,Khwaja Bahauddin Boys High School,0,0,510,925,1435
18,1814,1814201,لیسه امام ابو حنیفه,Imam Abu Hanifa High School,0,1,254,311,566
18,1814,1814202,مسجد شورتوغ,Shortoghi Mosque,0,0,196,439,635
18,1814,1814203,لیسه ذک ورکتک جر,Kotak Jar Boys High School,0,0,29,111,140
18,1815,1815204,مکتب متوسطۀ دروازه پته,Darwaza Pata Secondary School,0,1,69,118,188
18,1815,1815212,لیسه ذک ور درقد,Darqad Boys High School,0,11,300,625,936
18,1812,1812181,لیسه سری غ,Sarigh High School,0,0,414,422,836
18,1816,1816213,مکتب ابتدائیه چاه اب,Chah Aab Primary School,0,0,202,179,381
18,1816,1816214,لیسه ذک ور چاه آب,Chah Aab Boys High School,0,0,844,1949,2793
18,1816,1816215,مدرسه عیدگاه,Eidgah Madrasa,0,0,685,1141,1826
18,1816,1816216,مکتب ابتدایه انجی,Anjeez Primary School,0,0,678,248,926
18,1816,1816217,لیسه ذک ورعارف,Arif Boys High School,0,2,802,607,1411
18,1816,1816218,لیسه امام اعظم رح,Imam Azam High School,0,1,1166,1416,2583
18,1816,1816219,مکتب متوسطۀ شاه دره,Shah Dara Secondary School,0,0,466,471,937
18,1816,1816220,مسجد جامع,Jami Mosque,0,0,305,314,619
18,1816,1816221,مکتب ابتدایه رباط حمیدالدین,Rabat Hamiduddin Primary School,0,0,221,234,455
18,1816,1816222,مکتب شک دره,Shak Dara School,0,0,132,617,749
18,1816,1816223,مکتب متوسطۀ ورنخواه,Warankhwa Secondary School,0,0,530,518,1048
18,1816,1816224,مكتب ابتدائيه گذر صفكان,Guzar Safkan Primary School,0,0,1131,1028,2159
18,1816,1816225,مکتب ابتدائیه گزان,Gazan Primary School,0,0,557,541,1098
18,1816,1816226,مدرسه کلاتک,Kalatak Madrasa,0,0,273,173,446
18,1816,1816227,مکتب متوسطه ارگ شاه,Arg Shah Secondary School,0,0,370,315,685
18,1816,1816228,مکتب متوسطۀ انجی,Anjeer Secondary School,0,0,580,1159,1739
18,1816,1816229,مکتب متوسطه سمت,Samti Secondary School,0,1,691,1146,1838
18,1816,1816230,مکتب ابتدائیه خاسار,Khasar Primary School,0,0,596,508,1104
18,1816,1816231,مکتب متوسطۀ هودی,Hodi Secondary School,0,0,275,392,667
18,1817,1817232,مکتب رحیم آباد,Rahim Abad School,0,0,756,1562,2318
18,1817,1817234,مکتب بای آبه سرق,Bay Aaba Sharqi School,0,0,5,157,162
18,1817,1817237,مکتب متوسطه کفی علی,Kaftar Ali Secondary School,0,1,486,666,1153
18,1817,1817239,لیسه جلگه,Jalga High School,0,0,812,812,1624
19,1901,1901001,مکتب چله مزار,Chela Mazar School,0,1,1150,1669,2820
19,1901,1901002,لیسه فاطمه زهرا,Fatima Zahra High School,0,0,1747,2318,4065
19,1901,1901003,دفی احصایه مرکزی,Central Statistics Office,0,4,564,1175,1743
19,1901,1901004,لیسه عالی شی خان,Sher Khan High School,0,9,841,3806,4656
19,1901,1901006,شفاخانه سپی زر,Spin Zar Hospital,0,3,702,567,1272
19,1901,1901007,لیسه حضت علی,Hazrat Ali HighSchool,0,4,886,1756,2646
19,1901,1901008,مکتب ابتدائیه ن ن سمیه,Bibi Somaya Primary School,0,0,793,432,1225
19,1901,1901009,مکتب متوسطه ذکور سه درک,Se Darak Boys Secondary School,0,0,360,955,1315
19,1901,1901010,مسجد خالد بن ولید,Khalid Bin Walid Mosque,0,0,425,955,1380
19,1901,1901011,مکتب ذاخیل خمدان,Zakhel Khamdan School,0,2,506,929,1437
19,1901,1901012,کلینیک حیوان,Animal Clinic,0,7,296,549,852
19,1901,1901013,مسجد ورکشاب خاکت,Worshop Khakani Mosque,0,3,165,561,729
19,1901,1901014,مسجد جامع مدینه,Madina Jami Mosque,0,0,371,367,738
19,1901,1901015,سرکت سپی زر,Spin Zar Sharkat,0,1,651,2582,3234
19,1901,1901016,لیسه ذاخیل,Zakhel High School,0,6,175,527,708
19,1901,1901017,لیسه تجربوی سر آسیا سرکت,Sar Asia Sharkat High School,0,1,1014,2327,3342
19,1901,1901018,مسجد جامع چهل دخیان قدیم,Old Chel Dokhtaran Jami Mosque,0,2,414,1760,2176
19,1901,1901019,لیسه ن ن عایشه صدیقه,Bibi Aysha Sediqa High School,0,7,1333,1394,2734
19,1901,1901020,مسجدساق بان,Saqi Babi Mosque,0,1,482,857,1340
19,1901,1901021,لیسه مولوی سراج الدین,Maulvi Sirajuddin High School,0,2,1131,1832,2965
19,1901,1901022,لیسه خواجه مشهد,Khwaja Mashhad High School,0,2,1419,4129,5550
19,1901,1901023,لیسه غازی خان,Ghazi Khan High School,0,2,2777,3256,6035
19,1901,1901024,مکتب متوسطه رستاق آباد,Rostaq Abad Secondary School,0,1,1451,2743,4195
19,1901,1901025,ریاست امور زنان,Directorate of Women Affairs,0,0,559,748,1307
19,1901,1901026,مکتب متوسطه محمد سرور ظریف,Mohammad Sarwar Zarif Secondary School,0,0,327,1516,1843
19,1901,1901027,لیسه کهندژ,Khondaj High School,0,0,882,1352,2234
19,1901,1901028,مکتب متوسطه ترکمن ها,Turkmenha Secondary School,0,0,215,1117,1332
19,1901,1901029,مسجد امام قطیبه,Imam Qotaiba Mosque,0,13,963,1700,2676
19,1901,1901031,مدرسه جامع خالد بن ولید,Khalid Bin Walid Jami Madrasa,0,0,13,910,923
19,1901,1901032,مکتب انگور باغ,Angor Bagh School,0,0,374,971,1345
19,1901,1901033,مسجد جامع قزاق,Qazaq Jami Mosque,0,0,450,1584,2034
19,1901,1901034,مکتب متوسطه بولک اول,Bolak Awal Secondary School,0,1,389,1750,2140
19,1901,1901036,لیسه باغ میی,Bagh Meerai High School,0,0,26,1621,1647
19,1901,1901054,مکتب متوسطه باغ سرکت,Bagh e Sharkat Secondary School,0,5,64,134,203
19,1901,1901005,لیسه نسوان مرکزی,Markazi (central) Girls High School,0,10,1253,1657,2920
19,1902,1902060,لیسه جمعیت,Jamiat High School,0,0,957,2641,3598
19,1903,1903073,لیسه ذکور مرکزعلی آباد,Ali Abad Boys High School,0,0,532,798,1330
19,1903,1903074,مسجد خیل گدا,Khel Gada Mosque,0,0,447,489,936
19,1903,1903076,مکتب متوسطه کیسه توپک,Keesa Topak Secondary School,0,0,308,465,773
19,1903,1903077,مکتب متوسطه چیپ,Cheep Secondary School,0,1,141,260,402
19,1903,1903079,مکتب متوسطه نسوان حاج حسی,Haji Hussain Girls Secondary School,0,1,565,574,1140
19,1903,1903080,لیسه ذکور لرخان,Larkhabi Boys High School,0,1,517,467,985
19,1903,1903082,لیسه پل خشت,Puli Kheshtee High School,0,1,397,549,947
19,1903,1903083,متوسطه سمع الله شهید,Samiullah Shaheed Secondary School,0,3,553,746,1302
19,1904,1904088,لیسه محمد حسن میاخیل,Mohammad Hassan Miakhel High School,0,0,1239,1785,3024
19,1904,1904089,لیسه نمی2 مرکزی خان آباد,Khan Abad Central No.2 High School,0,1,485,924,1410
19,1904,1904090,لیسه نسوان خان آباد,Khan Abad Girls High School,0,1,1702,577,2280
19,1904,1904091,لیسه چهار توت,Char Toot High School,0,1,117,265,383
19,1904,1904093,مکتب متوسطه چهار سری,Char Sari Secondary School,0,0,0,593,593
19,1904,1904106,مسجد جمعه خوان صندوق سای,Sandoq Say Juma Khwani Mosque,0,1,1145,1280,2426
19,1904,1904107,مکتب عرب قدق,Arab Qodoq School,0,0,756,1569,2325
19,1904,1904111,مکتب متوسطه لاله کی,Lalake Secondary School,0,1,321,367,689
19,1904,1904112,مسجد جمعه خوان اوچقدق,Ochqodoq Juma Khwani Mosque,0,2,1078,1621,2701
19,1904,1904113,مسجد میالی,Mia Ali Mosque,0,1,446,583,1030
19,1904,1904114,مسجد سویکه,Soyka Mosque,0,3,488,1077,1568
19,1904,1904115,مکتب متوسطه ودان کلی,Wadan Kalai Secondary School,0,0,650,763,1413
19,1904,1904116,لیسه امی محمد شهید,Amir Mohammad Shaheed High School,0,2,673,544,1219
19,1904,1904117,مکتب ابتدائیه علی سینا علیا,Ali Sina Olia Primary School,0,2,473,509,984
19,1904,1904118,مکتب متوسطه دگری,Dagari Secondary School,0,0,299,496,795
19,1905,1905119,لیسه نسوان مرکزی,Central Girls High School,0,1,985,1215,2201
19,1905,1905120,لیسه نمی دوم امام صاحب,Imam Sahib No.2 High School,0,0,1182,2542,3724
19,1905,1905121,مکتب متوسطه عبدالرحمن ترک,Abdul Rahman Turk Secondary School,0,0,79,272,351
19,1905,1905122,لیسه ذکور امام صاحب,Imam Sahib Boys High School,0,1,757,2054,2812
19,1905,1905123,مکتب نمی ۱ امام صاحب,Imam Sahib No.1 High School,0,1,1425,1930,3356
19,1905,1905124,لیسه اورتبلاق,Ortablaqi High School,0,1,308,744,1053
19,1905,1905125,مکتب مجر,Majar School,0,1,884,993,1878
19,1905,1905134,مکتب آب فروشان,Aab Faroshan School,0,0,264,632,896
19,1905,1905135,مکتب ابتدائیه جیهون,Jehon Primary School,0,0,360,911,1271
19,1905,1905136,مکتب قنجوغه,Qanjogha School,0,1,299,576,876
19,1905,1905137,لیسه اجغن,Ajghan High School,0,0,492,575,1067
19,1905,1905138,مکتب متوسطه بیش کپه,Besh Kapa Secondary School,0,0,520,726,1246
19,1905,1905139,لیسه میزا عبدالقادربیدل,Mirza Abdul Qadir Bedil High School,0,1,750,592,1343
19,1905,1905140,مکتب باسوس,Basos School,0,1,1396,1489,2886
19,1905,1905141,مکتب متوسطه بته کشان,Bota Kashan Secondary School,0,0,792,1286,2078
19,1905,1905142,مکتب قره ول,Qarawal School,0,2,1447,1414,2863
19,1905,1905143,مکتب متوسطه مراد شیخ,Murad Shaikh Secondary School,0,0,585,1165,1750
19,1905,1905144,لیسه زرد کمر,Zard Kamar High School,0,0,1149,1180,2329
19,1905,1905145,مکتب ابتدایه خاتم النبی,Khatamul Nabeen Primary School,0,0,402,1296,1698
19,1905,1905146,لیسه قره کوترمه,Qara Kotarma High School,0,2,584,2321,2907
19,1905,1905147,مکتب شیخان بندر,Sher Khan Bandar School,0,1,503,2058,2562
19,1906,1906152,مکتب مصباح,Misbah Mosque,0,1,858,1954,2813
19,1906,1906153,لیسه حمید قرلق,Hamid Qarlaq High School,0,0,636,964,1600
19,1906,1906154,مکتب کوبیچ,Kobichi School,0,1,464,856,1321
19,1906,1906156,دارالمعلمی,Darul Malimin (tearchers training collecge),0,1,1365,2177,3543
19,1907,1907179,لیسه کلوخ تیپه,Kolokh Tapa High School,0,0,928,852,1780
19,1907,1907180,مکتب متوسطه باغیچه,Bagh e cha Secondary School,0,0,198,183,381
19,1907,1907181,مکتب خشت تپه,Khisht Tapa Secondary School,0,1,214,207,422
19,1910,1910211,مکتب متوسطه کهنه قلعه,Kohna Qala Secondary School,0,1,977,2041,3019
19,1910,1910212,لیسه آبشور جولیچه,Aabshor Jolicha High School,0,0,583,1179,1762
20,2001,2001001,مکتب متوسطه نسوان کارته خراسان,Kart e Khurasan Girls Secondary School,0,0,1446,1679,3125
20,2001,2001002,لیسه ذکور ایبک,Aybak Boys High School,0,1,393,2518,2912
20,2001,2001003,لیسه نسوان اجان ملکی,Ajani Malik Girls High School,0,2,3856,1719,5577
20,2001,2001004,لیسه آئینچه,Aayencha High School,0,1,1138,1594,2733
20,2001,2001005,مکتب متوسطه سرقد,Sarqad Secondary School,0,1,233,926,1160
20,2001,2001006,مکتب متوسطه لرغان,Larghan Secondary School,0,2,1067,866,1935
20,2001,2001007,لیسه جوی ژوندون,Nawai Zhwandoon High School,0,0,1110,763,1873
20,2001,2001008,مکتب ابتدا یه منگتاش,Mangtash Primary School,0,1,374,497,872
20,2001,2001009,مکتب متوسطه دلخکی,Dilkhakai Secondary School,0,1,635,496,1132
20,2001,2001010,مکتب متوسطه قوچ نهال,Qouch Nehal Secondary School,0,0,595,383,978
20,2001,2001011,مدرسه منغر,Manghaz Mosque,0,0,9,182,191
20,2001,2001012,مکتب متوسطه ساره کنده,Sarah Kandah Secondary School,0,0,298,471,769
20,2001,2001013,لیسه نسوان دره زندان,Darah e Zindan Girls High School,0,0,963,860,1823
20,2001,2001014,مکتب متوسطه تخت رستم,Takht e Rustam Secondary School,0,0,440,408,848
20,2001,2001015,لیسه نسوان شهر قدیم,Shahr e Qadeem Girls High School,0,17,827,796,1640
20,2001,2001016,مسجد جامع خواجه اسماعیل,Khwajah Ismael Jame Mosque,0,0,348,307,655
20,2001,2001017,مکتب متوسطه ظهران,Zahrabi Secondary School,0,19,692,832,1543
20,2001,2001018,مکتب ابتدا یه کپنک ارجه,Kapanak Arjah Primary School,0,0,110,62,172
20,2001,2001019,لیسه شلکتو,Shalkatu High School,0,0,7,187,194
20,2001,2001020,مکتب متوسطه سریکیار,Sharikyar Secondary School,0,0,93,189,282
20,2001,2001021,محل اجتماع,Mahal Ijtema (Gathering Place),0,0,61,390,451
20,2001,2001022,مکتب ابتدائیهء بابه لر,Baba Lar Primary School,0,0,1,98,99
20,2001,2001023,مسجد چهل کپه,Chehel Kapah Mosque,0,0,416,434,850
20,2001,2001024,مکتب متوسطه تیخونک,Taikhonak Secondary School,0,0,411,391,802
20,2001,2001025,مکتب متوسطه ربا طک,Rubatak Secondary School,0,0,4,208,212
20,2002,2002027,مکتب متوسطه نسوان کلچه,Kulchah Girls Secondary School,0,0,1195,1156,2351
20,2002,2002028,مکتب متوسطه قوش بره,Qush Barah Secondary School,0,2,317,546,865
20,2002,2002029,لیسه ذکور مرکز حضت سلطان,Markaz Hazrat Sultan Boys Secondary School,0,7,1519,1708,3234
20,2002,2002030,مکتب متوسطه دولت آباد,Dawlat Abad Secondary School,0,10,1274,1201,2485
20,2002,2002031,مکتب متوسطه کوکجر,Kokjar Secondary School,0,0,1224,1066,2290
20,2002,2002032,مکتب ابتدان چوچمن,Chochman Primary School,0,0,1381,1514,2895
20,2002,2002033,مسجد قدم علی,Qadam Ali Mosque,0,0,1277,1158,2435
20,2002,2002034,مسجد بابه مراد,Baba Murad Mosque,0,0,338,387,725
20,2003,2003035,مکتب متوسطه قیی,Qeenar Secondary School,0,0,571,545,1116
20,2003,2003036,مکتب سرآزان,Sar Azan School,0,0,346,405,751
20,2003,2003043,مکتب متوسطه بابه قمی,Ba Ba Qamar Secondary School,0,1,258,285,544
20,2003,2003045,مکتب متوسطه حضت نعمان,Hazrat Numan Secondary School,0,0,697,711,1408
20,2003,2003046,مکتب لیسه سید جمال الدین,Sayed Jamaluddin High School,0,0,1053,1086,2139
20,2003,2003047,مکتب ابتدائیه غازی مرد,Ghazi Mard Primary School,0,0,381,463,844
20,2003,2003048,لیسه اندر شی خرم,Andar Sher Khuram High School,0,0,1250,1321,2571
20,2004,2004049,مکتب ابتدائیه نو آباد,Nawabad Primary School,0,0,1182,860,2042
20,2004,2004050,مکتب ذکور فیوز نخچی,Feroz Nakhcheer Boys School,0,1,1941,1595,3537
20,2004,2004051,مکتب ابتدائیه قوش موله,Qosh Mollah Primary School,0,0,252,196,448
20,2005,2005052,کلینیک آبخورک علیا,Aabkhorak Ulya Clinic,0,0,481,325,806
20,2005,2005053,لیسه آبخورک سفلی,Aabkhorak Sufla High School,0,0,988,766,1754
20,2005,2005054,مدرسه چهار مغز سرای مابی,Chaharmaghz Sarai Mabain Madrassah,0,0,316,216,532
20,2005,2005055,مکتب متوسطه ذکور دوآب,Du Aab Boys Secondary School,0,0,543,608,1151
20,2005,2005056,مدرسه مسجد جامع,Masjid Jame Madrassah (Jame Mosque Madrassah),0,0,913,732,1645
20,2005,2005057,لیسه مدیرک,Mudeerak High School,0,0,924,664,1588
20,2005,2005058,مکتب اناثیه سرخ قلعه,Surkh Qalla Girls School,0,1,514,802,1317
20,2005,2005060,مسجد قرغنه بالا,Qarghanah Bala Mosque,0,0,109,97,206
20,2005,2005062,مکتب ابتدائیه جوپلال,Joplal Primary School,0,0,799,0,799
20,2005,2005064,لیسه عبدالعزیز,Abdul Aziz High School,0,0,763,1272,2035
20,2005,2005065,مکتب ابتدائیه موهو,Moho Primary School,0,1,433,370,804
20,2005,2005066,مدرسه اسدیه,Asadyah High School,0,0,297,366,663
20,2005,2005067,مدرسه خواجه زاحد,Khwajah Zahid Madrassah,0,1,515,501,1017
20,2005,2005068,مکتب متوسطه قشقه,Qashqah Secondary School,0,0,286,412,698
20,2005,2005069,مدرسه ایماق,Aimaq High School,0,0,200,337,537
20,2005,2005070,منی بلغلی,Menbar Bulghali,0,2,458,518,978
20,2005,2005071,لیسه ذکور علاوالدین,Alauddin Boys Secondary School,0,0,893,1026,1919
20,2005,2005072,لیسه آبخورک علیا,Aabkhorak Ulya Secondary School,0,0,465,485,950
20,2005,2005073,مسجد سرغازی,Sar Ghazi Mosque,0,0,58,228,286
20,2006,2006074,مسجد جامع دایکندی,Daikundi Jame Mosque,0,0,3,18,21
20,2006,2006075,مسجد ن زار,Naizar Mosque,0,0,27,54,81
20,2006,2006076,مسجد پالی پایه,Palez Payah Mosque,0,0,75,687,762
20,2006,2006079,مکتب قریه تاقچ,Taqchi village School,0,0,248,376,624
20,2006,2006081,مکتب متوسطه کته قاق,Katah Qaq Secondary School,0,1,599,901,1501
20,2006,2006082,مکتب متوسطه توقسن,Toqsun Secondary School,0,0,412,1000,1412
20,2006,2006083,مسجد تولی غازی,Tolai Ghazi Mosque,0,1,373,1158,1532
20,2006,2006084,لیسه ذکور دهی,Dehi Boys High School,0,0,914,1937,2851
20,2006,2006085,لیسه امام ابوحنیفه,Imam Abu Haneefah High School,0,0,817,751,1568
20,2006,2006086,مکتب متوسطه چوبکی,Chobaki Secondary School,0,0,640,434,1074
20,2006,2006087,مسجد خانه سنکی,Khanah e Sangi Mosque,0,0,429,974,1403
20,2006,2006088,صالون اجتماعی ایمانان,Imanan Community Hall,0,1,420,688,1109
20,2006,2006089,مدرسه زاغ پایان,Zagh Payan Madrassah,0,0,126,477,603
20,2006,2006091,لیسه سر دشت,Sar e Dasht High School,0,0,491,704,1195
20,2006,2006092,مسجد اوته,Owtah Mosque,0,0,160,776,936
20,2006,2006093,مدرسه بازارک,Bazarak Madrassah,0,0,228,542,770
20,2006,2006094,مسجد جامع گوله حصار,Golah E Hesar Jame Mosque,0,0,376,1052,1428
20,2007,2007095,منی کوته,Menbar Kotah,0,0,824,849,1673
20,2007,2007096,لیسه ذکورچهارده,Chahardeh Boys High School,0,0,1001,405,1406
20,2007,2007097,منی زیر سنگ,Menbar Zer Sang,0,0,691,653,1344
20,2007,2007098,مکتب شیخه,Shiekha School,0,0,555,754,1309
20,2007,2007099,منی جیهون,Menbar Jaihoon,0,0,1043,1420,2463
20,2007,2007101,منی کته قشلاق,Menbar Katah Qeshlaq,0,0,0,664,664
20,2007,2007102,منی سرخ شهر,Menbar e Surkh Shahr,0,0,593,661,1254
20,2007,2007103,مسجد علی آباد,Ali Abad Mosque,0,0,176,153,329
20,2007,2007104,لیسه ذکور بازار سوخته,Bazar Soukhtah Boys High School,0,0,1919,2413,4332
20,2007,2007105,مکتب سر اولنگ,Sar Awlang School,0,0,585,632,1217
20,2007,2007106,مکتب دهن شوراب,Dahan e Shorab School,0,0,1116,576,1692
20,2007,2007107,مکتب نسوان زیره کی,Zeeraki Girls School,0,0,805,807,1612
20,2007,2007108,مکتب متوسطه سری شورآب,Sar e Shorab Secondary School,0,0,403,408,811
20,2007,2007109,منی هشتلی,Hashtlez Menbar,0,0,332,315,647
20,2007,2007110,منی حسن,Menbar Hassani,0,1,1024,1138,2163
20,2007,2007111,مکتب لیسه ذکور دهن تور,Dahan Tour Boys High School,0,0,1536,902,2438
20,2007,2007112,منی بین منگ,Menbar Beni Mang,0,0,1153,1126,2279
20,2007,2007113,منی اوی بلاق,Menbar Awi Bulaq,0,0,811,396,1207
20,2007,2007114,مکتب سابق قورق,Quraq old School,0,0,384,351,735
20,2007,2007115,مکتب متوسطه سرخ ده,Surkh Deh Secondary School,0,0,305,264,569
21,2102,2102051,مکتب ابتدائیه علی سینا بلچ,Ali Sena Balkhi Primary School,0,2,1865,1751,3618
21,2102,2102052,مکتب قلعه قل محمد,Qalla Qul Mohammad School,0,2,611,735,1348
21,2102,2102053,لیسه علی آباد,Ali Abad High School,0,3,2881,3745,6629
21,2102,2102054,لیسه راه معرفت,Rah e Marefat High School,0,0,1592,1445,3037
21,2102,2102056,مکتب سیاه گرد,Syah Gerd School,0,0,547,878,1425
21,2102,2102057,مکتب شهرک ترکمنیه,Shahrak Turkmaniah School,0,39,811,1313,2163
21,2102,2102058,مکتب ابو المطیع بلچ,Abul Mati Balkhi School,0,0,1535,1371,2906
21,2102,2102059,لیسه عالی محمد یوسف خیخ واه,Mohammad Yousuf Khairkhwah High School,0,31,2333,2535,4899
21,2102,2102060,لیسه شادیان,Shadyan High School,0,0,607,571,1178
21,2103,2103061,مسجد شیف حضت ابوبکر صدیق,Hazrat Abu Baker Sdeique Mosque,0,1,426,451,878
21,2103,2103062,لیسه استاد ذبیح الله شهید,Ustad Zabiullah Shaheed High School,0,1,635,703,1339
21,2103,2103063,مکتب ابو زید,Abu Zaid School,0,1,1478,1910,3389
21,2103,2103064,مکتب شیخ ثمر الدین شهاب,Shiekh Samaruddin Shahab School,0,2,1252,1584,2838
21,2103,2103065,مکتب چهل گزی,Chehel Gazi School,0,0,832,1152,1984
21,2103,2103066,لیسه دهسوار,Dehsawar High School,0,2,479,585,1066
21,2103,2103067,مکتب کاکا کوت,Ka Ka Kot School,0,0,548,582,1130
21,2103,2103068,مکتب ی ی زینب,Bi Bi Zainab School,0,3,1419,1637,3059
21,2103,2103069,مکتب توخته,Tokhtah School,0,0,778,956,1734
21,2103,2103070,مکتب صالح محمد,Saleh Mohammad School,0,3,797,990,1790
21,2103,2103071,لیسه نسوان قلعه جنگ,Qalla e Jangi Girls High School,0,2,479,298,779
21,2103,2103072,مکتب شیخ آباد,Shiekh Abad School,0,1,416,434,851
21,2103,2103073,لیسه عالی شهید بلچ,Shaheed Balkhi High School,0,0,552,1036,1588
21,2103,2103074,مکتب غلام محمد شهید,Ghulam Mohammad Shaheed School,0,1,481,1044,1526
21,2103,2103075,مکتب عابده بلچ,Abida Balkhi School,0,3,1418,1700,3121
21,2104,2104076,مکتب شور بلاق,Shor Bulaq School,0,0,153,1059,1212
21,2104,2104077,مکتب تندورک,Tandurak School,0,0,172,462,634
21,2104,2104078,مکتب نان وای,Nanwayee School,0,3,1331,1449,2783
21,2104,2104079,مکتب سفید چشمه,Safid Chashmah School,0,0,329,380,709
21,2104,2104080,مکتب شش سفلی,Shar Shar Sufla School,0,0,462,0,462
21,2104,2104081,مکتب یکه تال,Yakah Tal School,0,0,271,337,608
21,2104,2104082,مکتب شاه انجی,Shah Enjeer School,0,0,272,341,613
21,2104,2104083,مکتب ازوُم چاه,Owzom Chah School,0,1,238,329,568
21,2104,2104084,مدرسه کهنه جر,Kuhnah Jar Madrassah,0,2,499,1305,1806
21,2104,2104085,مکتب می حاخ,Mir Haji School,0,2,1123,2300,3425
21,2104,2104086,مکتب خواجه بندی,Khwajah Bandi School,0,1,562,1128,1691
21,2104,2104087,مکتب پس قدوق,Pas Qadooq School,0,0,1378,2315,3693
21,2104,2104088,مکتب جان بلاق,Jan Bulaq School,0,0,541,1124,1665
21,2105,2105089,لیسه ابو عصمت,Abu Esmat High School,0,3,1778,2475,4256
21,2105,2105090,لیسه نسوان مارمل لب سای,Marmul Lab Sai Girls High School,0,0,1512,1671,3183
21,2105,2105091,مکتب پرواز,Parwaz School,0,2,582,1136,1720
21,2106,2106092,لیسه نوب هار,Nawbahar High School,0,55,905,1940,2900
21,2106,2106093,لیسه نسوان فریده,Fareedah Girls High School,0,74,1096,1357,2527
21,2106,2106094,مکتب امی محمد توخ,Amir Mohammad Tokhi School,0,3,725,321,1049
21,2106,2106095,مکتب حاخ کوت,Haji Kot School,0,3,755,854,1612
21,2106,2106096,مکتب دیره گ,Deragai School,0,129,615,492,1236
21,2106,2106097,مکتب بهاألدین,Bahauddin School,0,131,656,869,1656
21,2106,2106098,مکتب ارغون,Arghon School,0,3,256,344,603
21,2106,2106099,مکتب کولمبو,Colambo School,0,702,634,848,2184
21,2106,2106100,مکتب بر مزیت,Bar Mazyat School,0,20,912,726,1658
21,2106,2106101,مکتب دی والی میدان,Dewali Maidan School,0,0,569,437,1006
21,2106,2106102,مکتب متوسطه باغشور,Baghshor Secondary School,0,421,194,342,957
21,2106,2106103,مکتب مهمندان,Mohmandan School,0,326,1421,1695,3442
21,2106,2106104,مکتب ایلقیچ,Elqichi School,0,1,207,286,494
21,2106,2106105,مسجد ارغنداب,Arghandab Mosque,0,0,140,223,363
21,2106,2106106,مکتب سالارزی,Salarzai School,0,1,665,373,1039
21,2106,2106107,مکتب واله گ,Walah Gai School,0,3,92,548,643
21,2106,2106108,مکتب کته خیل,Kata Khil School,0,548,337,465,1350
21,2106,2106109,مکتب سپی کوت,Speen Kot School,0,0,574,638,1212
21,2106,2106110,مکتب چار باغ گلشن,Char Bagh Gulshan School,0,76,667,966,1709
21,2106,2106112,مکتب شهید رح مت الله,Shaheed Rahmatullah School,0,18,773,1032,1823
21,2106,2106113,مکتب ذک ور چهارسنگ,Chahar Sang Boys School,0,2,942,820,1764
21,2106,2106114,مکتب دهرازی,Dehrazi School,0,0,526,608,1134
21,2106,2106115,مکتب نسوان حصارک,Hesarak Girls School,0,0,541,598,1139
21,2106,2106116,مکتب نسوان ثمر قندیان,Samar Qandyan Girls School,0,3,1110,1296,2409
21,2106,2106117,مکتب اوف ملیک,Owf Melak School,0,5,390,419,814
21,2106,2106118,مکتب کشکک,Keshkak School,0,6,1343,1397,2746
21,2106,2106111,مکتب بوکه,Bokah School,0,3,765,991,1759
21,2107,2107119,مکتب مولاناعبدالرحمن جامی,Mawlana Abdul Rouf Jami School,0,194,1348,882,2424
21,2107,2107120,لیسه عالی قدیم,Qadeem High School,0,6,1918,1898,3822
21,2107,2107121,مکتب تاجک,Tajik School,0,0,635,500,1135
21,2107,2107122,مکتب ای لاتان,Ae Latan School,0,7,637,460,1104
21,2107,2107123,مسجدامام ابوحنیفه,Imam Abu Hanifah Mosque,0,17,414,271,702
21,2107,2107124,لیسه سید جمال الدین افغای,Sayed Jamaluddin Afghani High School,0,0,993,730,1723
21,2107,2107125,مسجد زوار ها,Zawar ha Mosque,0,0,1019,763,1782
21,2107,2107126,مکتب ی ی مریم,Bi Bi Maryam School,0,2,963,765,1730
21,2107,2107127,مکتب احمد الخضویه,Ahmad Al Khuzrowayah School,0,2,1166,991,2159
21,2107,2107128,تکیه خانه حاخ نظر,Haji Nazar Takya Khanahh,0,0,346,342,688
21,2107,2107129,مکتب ی ی آمنه,Bi Bi Amenah School,0,0,981,694,1675
21,2107,2107130,تکیه خانه آغاجان,Agha Jan Takya Khanahh,0,0,422,379,801
21,2107,2107131,مکتب سیاب,Syab School,0,17,771,987,1775
21,2107,2107132,مکتب قلند خلیلی,Qaland Khalili School,0,0,888,668,1556
21,2107,2107133,لیسه باغ پهلوان,Bagh Pahlawan High School,0,108,1235,1448,2791
21,2107,2107134,مکتب اسی کوت,Aster Kot School,0,124,747,997,1868
21,2107,2107135,مکتب پیکان دره,Paikan Darah School,0,0,1126,1710,2836
21,2107,2107136,مکتب رح مت آباد,Rahmat Abad School,0,0,500,1070,1570
21,2107,2107137,مسجد اغر سای,Agahar Sai Mosque,0,0,141,482,623
21,2107,2107138,مکتب قاق لوسای,Qaq Lu Sai School,0,1,357,503,861
21,2107,2107139,تکیه خانه آقچه دالان,Aaqcha Dalan Takya Khanahh,0,0,972,1087,2059
21,2107,2107140,مکتب متوسطه دالان,Dalan Secondary School,0,0,338,363,701
21,2107,2107141,مسجد شورچه,Shorchah Mosque,0,234,199,397,830
21,2107,2107142,مکتب چر خاب,Charkhab School,0,2,342,280,624
21,2107,2107143,مکتب پل برق,Pul e Barq School,0,7,969,1415,2391
21,2107,2107144,مکتب قزل کنت,Qazal Kant School,0,0,377,361,738
21,2107,2107145,مسجد نوقشلاق,Naw Qeshlaq Mosque,0,0,143,203,346
21,2107,2107146,مکتب جنیتو,Janeetu School,0,0,761,868,1629
21,2107,2107147,مکتب کاندلی,Kandali School,0,0,157,242,399
21,2107,2107148,مکتب کیچه قزل,Keecha Qazal School,0,0,411,324,735
21,2107,2107149,مکتب تبیاق,Tabyaq School,0,5,704,611,1320
21,2107,2107150,مسجد طبیاق,Tabyaq School,0,1,341,248,590
21,2107,2107315,مکتب وی ماهوت,Wimahot School,0,0,1285,597,1882
21,2108,2108151,مسجد مچلدی,Machaldi Mosque,0,0,123,231,354
21,2108,2108154,کلینیک چقناق,Chiqnaq Clinic,0,0,347,580,927
21,2108,2108155,مکتب حاخ برف,Haji Barfi School,0,0,836,983,1819
21,2108,2108157,مکتب ملا جمعه خان,Mulla Juma Khan School,0,0,561,710,1271
21,2108,2108170,لیسه نسوان جنگل,Jangal Girls High School,0,0,515,796,1311
21,2108,2108171,کلینیک بای تیمور,Bye Taimoor Clinic,0,4,365,573,942
21,2108,2108172,تعمیجدیدولسوالی,New building of the District Admin Office,0,1,403,492,896
21,2108,2108173,مکتب پالو زولی,Palo Zolai School,0,1,747,876,1624
21,2108,2108174,مکتب چمتال,Chemtal School,0,198,758,1056,2012
21,2108,2108175,لیسه ذک ور شآسیاب,Sar Asyab Boys High School,0,2,1043,1302,2347
21,2108,2108176,مکتب می قاسم جان,Mir Qasim Jan School,0,0,907,1126,2033
21,2108,2108177,مکتب رباط,Rubat School,0,0,1712,2049,3761
21,2109,2109178,مکتب رابعه بلچ,Rabia Balkhi School,0,7,1206,1582,2795
21,2109,2109179,لیسه ابو نض فارای,Abu Nasr Faryabi High School,0,0,350,566,916
21,2109,2109180,مکتب چهار باغ سیدان,Char Bagh Sayedan School,0,0,517,466,983
21,2109,2109181,مکتب حیاتان,Hayatan School,0,0,378,424,802
21,2109,2109182,مکتب تالی گک,Taligak School,0,1,199,332,532
21,2109,2109183,کلینیک قرش گک,Qarshigak Clinic,0,0,1159,850,2009
21,2109,2109188,مکتب چاهی,Chahi School,0,0,3,22,25
21,2109,2109191,مکتب خواله بچگان,Khwalah Bachgan School,0,0,446,638,1084
21,2109,2109192,مکتب الحاقیه باغشور,Ilhaqyah Baghshor School,0,0,283,255,538
21,2109,2109193,مکتب بای مشهد,Bye Mashad School,0,13,991,406,1410
21,2109,2109194,مسجد جامع افغانیه,Afghania Jame Mosque,0,18,0,656,674
21,2109,2109195,مکتب هاشم آبادوطت,Hashimabad watani School,0,1,39,172,212
21,2109,2109196,مکتب نخچیآباد,Nakhcheerabad School,0,0,269,367,636
21,2109,2109197,مکتب شخ گنبد,Surkh Gunbad School,0,0,438,351,789
21,2109,2109198,مکتب زادیان,Zadyan School,0,0,311,377,688
21,2109,2109199,مکتب شینگل آباد,Shingal School,0,0,164,291,455
21,2109,2109200,مکتب آناث واعظ,Anas Waezi School,0,0,526,403,929
21,2109,2109201,لیسه ذک ور مولانا واعظ,Mawlana Waezi Boys High School,0,0,688,585,1273
21,2109,2109202,مکتب شاخ مغیلان,Shakh Mugheelan School,0,0,269,251,520
21,2109,2109203,مکتب خی آباد,Khairabad School,0,0,238,423,661
21,2110,2110204,لیسه پوهاند عبدالروف خلمی,Pohand Abdul Rouf Khulmi High School,0,0,341,430,771
21,2110,2110205,مکتب تنگ,Tangi School,0,0,341,483,824
21,2110,2110206,شفاخانه خلم,Khulm Hospital,0,0,720,1423,2143
21,2110,2110207,مکتب ذک ور خواجه برهان,Khwajah Burhan Boys School,0,2,1409,1537,2948
21,2110,2110208,لسیه مهست,Mahasthi High School,0,0,1260,663,1923
21,2110,2110209,لیسه ذک ور خلم,Khulm Boys High School,0,1,673,1810,2484
21,2110,2110210,لیسه شهید احمد شاه مسعود,Shaheed Ahmad Shah Masoud High School,0,0,1032,951,1983
21,2110,2110211,مکتب ناهید شهید,Nahid Shaheed School,0,0,526,371,897
21,2110,2110212,مکتب می زاشمس,Mirza Shams School,0,1,529,537,1067
21,2110,2110213,کلینیک حاخ علی,Haji Ali Clinic,0,0,242,269,511
21,2110,2110214,مکتب ذک ور صیاد,Sayad Boys School,0,1,507,479,987
21,2110,2110215,مکتب ینگ اریق,Yangi Areeq School,0,0,99,245,344
21,2110,2110216,مکتب متوسطه خوشتوت,Khushtoot Secondary School,0,0,62,84,146
21,2110,2110217,مکتب متوسطه غازی آباد,Ghazi Abad Secondary School,0,0,155,168,323
21,2110,2110218,مکتب متوسط ناهید شهید,Nahid Shaheed Secondary School,0,0,190,185,375
21,2110,2110219,مکتب ده حسن,Deh Hasan School,0,0,517,456,973
21,2110,2110220,مسجد قریه ده ورده,Deh Wardah village Mosque,0,0,49,111,160
21,2110,2110221,مکتب متوسطه اولجتو,Awaljtu Secondary School,0,1,492,363,856
21,2111,2111222,مکتب یلمان,Yalman School,0,298,1049,1179,2526
21,2111,2111223,مکتب علی آباد,Aliabad School,0,0,197,494,691
21,2111,2111224,مکتب نوی کوت,Nawai Kot School,0,0,1,1,2
21,2111,2111225,مسجد جامع قریه ثوریان,Suryan village Jame Mosque,0,0,286,756,1042
21,2111,2111231,مکتب چوبه,Chobah School,0,0,16,9,25
21,2111,2111232,مکتب حمید بابا,Hamid Ba Ba School,0,0,348,1064,1412
21,2111,2111233,مکتب بدایع بلچ,Badaee Balkhi School,0,0,36,132,168
21,2111,2111234,مکتب ابو شکور بلچ,Abu Shukoor Balkhi School,0,0,435,497,932
21,2111,2111235,مکتب سکندر خیل ژنگوره,Sikandar Khil Zhangoorah School,0,3,451,658,1112
21,2111,2111236,مکتب دلیجی,Tannah School,0,0,238,353,591
21,2111,2111237,مسجدقریه ملا شاهی,Mullah Shaheen village Mosque,0,630,582,414,1626
21,2111,2111238,تعمی شورای انکشاف,Development Council Building,0,76,507,351,934
21,2111,2111239,تعمی ولسوالی,District Building,0,1,745,971,1717
21,2111,2111240,مدیریت معارف,Education Directorate,0,0,383,490,873
21,2111,2111242,مسجد جامع آدینه,Aadenah Jame Mosque,0,0,220,364,584
21,2111,2111243,مکتب ارناغه,Arnagha School,0,1,376,663,1040
21,2111,2111246,مکتب منگولی,Mangoli School,0,0,74,263,337
21,2111,2111247,مکتب احمد آباد,Ahmad Abad School,0,0,94,299,393
21,2112,2112254,مکتب دالی,Dali School,0,0,6,690,696
21,2112,2112255,مکتب شور آریق,Shor Ariq School,0,0,0,856,856
21,2112,2112256,مکتب بوزاریق,Bozariq School,0,0,64,711,775
21,2112,2112257,مکتب ابو جعفر,Ab Jafar School,0,0,204,1694,1898
21,2112,2112258,مکتب بهبود,Behbod School,0,1,70,294,365
21,2112,2112259,مکتب تاشگذر,Tashguzar School,0,0,1023,1344,2367
21,2112,2112260,مکتب ارنچ بشیلی,Aranji Basheerli School,0,0,443,599,1042
21,2112,2112261,مکتب جیتان,Jeertan School,0,0,424,941,1365
21,2113,2113262,مکتب ابتدایه شچاه,Sarcha Primary School,0,0,131,247,378
21,2113,2113263,لیسه اناث ناصر خسرو,Naser Khesraw Girls High School,0,0,448,892,1340
21,2113,2113264,مکتب متوسطه تاسیسات,Tassesat Secondary School,0,0,367,521,888
21,2113,2113265,مکتب متوسطه تزلاق,Tuzlaq Secondary School,0,0,466,449,915
21,2113,2113266,مکتب متوسطه آری غ ایاق,Aregh Ayaq Secondary School,0,1,448,264,713
21,2113,2113267,مکنب متوسطه جوی جدید,Joi Jadeed Secondary School,0,0,131,485,616
21,2113,2113268,مکتب قرن توف,Qaran Toqi School,0,3,304,401,708
21,2113,2113269,لیسه مرکزی ولسوالی کلدار,Kaldar District Center High School,0,1,118,590,709
21,2113,2113270,مکتب متوسطه بوزآری خ,Bozaarekh Secondary School,0,0,243,613,856
21,2113,2113271,مسجدجامع تازه آری غ,Taza Areegh Jame Mosque,0,0,295,366,661
21,2113,2113272,مکتب متوسطه قریه کهنه کلدار,Kuhnah Kaldar village Secondary School,0,0,153,399,552
21,2114,2114273,مکتب کشنده بالا,Kushindah Bala School,0,2,841,950,1793
21,2114,2114274,مکتب نسوان کشنده بالا,Kushindah Bala Girls School,0,0,357,529,886
21,2114,2114275,مکتب کشنده پایان,Kushindah Payan School,0,0,909,838,1747
21,2114,2114276,مسجد قوشمسای,Qushum Sai Mosque,0,0,206,284,490
21,2114,2114277,مر کزاجتماعی,Markaz Ijtemai (Social Center),0,0,0,170,170
21,2114,2114278,مسجدچشمه للمی,Chashma e Lalmi Mosque,0,0,805,543,1348
21,2114,2114279,مکتب آق کوپروک,Aaq Kupruk School,0,2,1443,1179,2624
21,2114,2114280,مکتب چشمه سوال,Chashma Sawal School,0,0,107,115,222
21,2114,2114281,مکتب بام پشت,Bam Pusht School,0,0,317,257,574
21,2114,2114282,مکتب قریه سوخته,Qaryah e Soukhtah School,0,2,469,419,890
21,2114,2114283,مکتب شاب,Sarab School,0,0,677,624,1301
21,2114,2114284,مکتب چکانه پایان,Chakanah Payan School,0,1,153,594,748
21,2114,2114285,مکتب قربای سه درخ ت,Qurbye SehDarakht School,0,0,190,365,555
21,2114,2114286,مکتب ای هریره,Abi Hurairah School,0,0,125,132,257
21,2114,2114287,مکتب خواجه شخ,Khwajah Surkh School,0,0,243,427,670
21,2114,2114288,مکتب تونج,Tonj School,0,0,355,466,821
21,2114,2114289,مسجدپسته مزار,Pestah Mazar Mosque,0,0,55,203,258
21,2114,2114290,مسجد کرم شاهی,Karam Shahi Mosque,0,0,75,299,374
21,2114,2114291,مکتب چکانه بالا,Chakanah Bala School,0,1,211,823,1035
21,2114,2114292,مکتب واخشک,Wakhushk School,0,1,430,962,1393
21,2114,2114293,مکتب یرغان,Yarghan School,0,1,404,1069,1474
21,2114,2114294,مکتب شیخ شدره,Shiekh Sar Darah School,0,0,467,483,950
21,2115,2115295,مکتب بایه,Bayah School,0,3,412,988,1403
21,2115,2115296,لیسه خاتم الانبیا,Khatimul Anbya High School,0,1,547,1133,1681
21,2115,2115297,مکتب امام حسن,Imam Hasan School,0,0,554,1128,1682
21,2115,2115298,مکتب ابوذرغفاری,Abu Zar Ghafari School,0,1,929,2163,3093
21,2115,2115299,مکتب خواجه روشنای,Khwajah Roshnayee School,0,1,482,1728,2211
21,2115,2115300,مکتب بازار کهنه,Bazar Kuhnah School,0,0,1137,583,1720
21,2115,2115301,مسجد بخت گان,Bakhtgan Mosque,0,0,413,1094,1507
21,2115,2115302,مکتب امام هادی,Imam Mahdi School,0,1,1159,562,1722
21,2115,2115303,مکتب متوسطه عبدالگان,Abdulgan Secondary School,0,0,918,1701,2619
21,2115,2115304,محل مجتمع شورا,Mahal Mujtame Shura (Shura Gathering place),0,2,576,1757,2335
21,2115,2115305,مکتب چقورک,Chuqurak School,0,0,387,418,805
21,2115,2115306,مسجد کلان بلوچ,Kalan Balouch Mosque,0,0,360,255,615
21,2115,2115307,مسجدرشکان,Rashkan Mosque,0,0,41,83,124
21,2115,2115308,مکتب نسوان ایلاقیه,Aylaqia Girls School,0,0,423,432,855
21,2115,2115309,مکتب ابو القاسم,Abul Qasim School,0,0,852,776,1628
21,2115,2115310,مکتب ابتدائیه اومگ,Awmki Primary School,0,0,179,230,409
21,2115,2115311,مکتب میهاشم,Mir Hashim School,0,0,439,551,990
21,2115,2115312,مکتب خواجه احمد سیوی,Khwajah Ahmad Sewi School,0,0,114,360,474
21,2115,2115313,مکتب خواجه احمد ولی,Khwajah Ahmad Wali School,0,0,160,368,528
21,2115,2115314,مکتب پسته بلوچ,Pestah Balouch School,0,0,527,887,1414
21,210101,2101001,انستیتوت اداره وحسابداری,Administration and Accounting Institute,0,1,1593,2079,3673
21,210101,2101002,سیلو,Seelo,0,2,2092,2703,4797
21,210101,2101003,مکتب وزیر اکی خان,Wazir Akbar Khan School,0,0,975,2056,3031
21,210101,2101004,لیسه سلطان راضیه,Sultan Razia High School,0,1,1764,1691,3456
21,210101,2101005,تعمی شاروالی مزار,Mazar Municipality Building,0,1,528,1700,2229
21,210101,2101006,لیسه فاطمه بلچ,Fatima Balkhi High School,0,73,1899,1337,3309
21,210102,2101007,مکتب قاض حمید الدین,Qazi Hameeduddin School,0,29,594,853,1476
21,210102,2101008,دار الحفاظ اسدیه,Asadyah Darulhefaz,0,0,385,682,1067
21,210102,2101010,لیسه هاشم برات,Hashim Barat High School,0,1,1133,900,2034
21,210102,2101011,ریاست زراعت,Agriculture Directorate,0,1,1591,1816,3408
21,210102,2901008,لیسه گوهر شاد بیگم,Gohar Shad Begam High School,0,0,985,854,1839
21,210103,2101012,لیسه باخی,Bakhtar High School,0,8,1778,2979,4765
21,210103,2101013,مکتب بکتاش,Baktash School,0,2,798,2471,3271
21,210103,2101014,لیسه عایشه افغان,Ayesha Afghan High School,0,0,1043,1312,2355
21,210103,2101015,مکتب سلطان غیاث الدین,Sultan Ghyasuddin School,0,3,334,2649,2986
21,210104,2101016,مکتب مولانا جلا ل الدین,Mawlana Jalaluddin School,0,328,3546,3895,7769
21,210104,2101017,مکتب ابو مسلم خراسای,Abu Muslim Khurasani School,0,0,552,1111,1663
21,210105,2101018,نساخ,Nasaji,0,1,1073,1530,2604
21,210105,2101019,مکتب سید اسماعیل بلچ,Sayed Ismael Balkhi School,0,4,3336,3093,6433
21,210105,2101020,مکتب نهر توپ,Nahar Toup,0,2,1598,1500,3100
21,210105,2101021,مکتب یُلمرب ازبکیه,Yulmarb Uzbakiah School,0,0,378,405,783
21,210105,2101022,مکتب روشانه بلچ,Roshana Balkhi School,0,8,906,846,1760
21,210105,2101023,لیسه گوهر خاتون,Gowhar Khatoon High School,0,0,728,757,1485
21,210105,2101024,لیسه استقلال,Isteqlal High School,0,1,988,2207,3196
21,210106,2101025,مکتب شیخ شهاب,Shiekh Shahab School,0,1,1114,1092,2207
21,210106,2101026,انستیتیوت نفت وگاز,Oil and Gas Institute,0,2,355,1584,1941
21,210106,2101027,مکتب غلام رسول سنائ,Ghulam Rasoul Sanayee School,0,0,680,1267,1947
21,210106,2101044,مکتب هلا ل الدین بلچ,Hilaludin Balkhi School,0,0,1311,1121,2432
21,210107,2101028,مکتب استاد جاهد,Ustad Jahid School,0,0,477,906,1383
21,210107,2101029,لیسه دقیق بلچ,Daqeeqi Balkhi High School,0,2,1092,1474,2568
21,210107,2101030,مکتب ترای,Turabi School,0,97,953,819,1869
21,210107,2101031,مکتب اناث خراسان,Khurasan Girls School,0,144,3314,3086,6544
21,210107,2101032,مکتب مقصودالله شهید,Maqsoodullah Shaheed School,0,4,582,675,1261
21,210108,2101033,مکتب شهید عبد العلی مزاری,Shaheed Abdul Ali Mazari School,0,2,1383,911,2296
21,210108,2101034,مکتب متوسطه ذک ور بخدی,Bukhdi Boys Secondary School,0,0,1060,1017,2077
21,210108,2101035,مکتب هدایت الله نقشبندی,Hedayatullah Naqshbandi School,0,5,1326,1293,2624
21,210108,2101036,مکتب نور خدا,Noor Khuda School,0,23,2024,2013,4060
21,210108,2101037,لیسه بلخ باستان,Balkh Bastan High School,0,3,1839,1573,3415
21,210109,2101038,مکتب دول ت آباد اول,Dawlat Abad Awal School,0,0,308,391,699
21,210109,2101039,مکتب سید یحت عمری,Sayed Yahya Omeri School,0,0,832,972,1804
21,210109,2101040,مکتب نو بهار,Nawbahar School,0,15,1485,1068,2568
21,210109,2101041,مکتب مهدیه,Mahdiah School,0,0,574,621,1195
21,210109,2101042,لیسه غازی اما ن الله,Ghazi Amanullah High School,0,3,891,1041,1935
21,210109,2101043,مکتب ابتدایه عبدالحفیظ جلیلی,Abdul Hafiz Jalili Primary School,0,2,118,176,296
21,210110,2101045,مکتب متوسطه عبدالقادر خُلمی,Abdul Qader Khulmi Secondary School,0,3,1675,1112,2790
21,210110,2101046,لیسه استاد وجدان,Ustad Wejdan High School,0,1,1369,1534,2904
21,210110,2101047,مکتب شهید عبد العلی مزاری 2,Shaheed Abdul Ali Mazari School no. 2,0,3,1469,1985,3457
21,210110,2101048,لیسه عالی نمی یک سجادیه,Sejadiah High School no. 1,0,0,1961,1639,3600
21,210110,2101049,مکتب متوسطه ابوریحان البیوی,Abu Rehan Alberouni Secondary School,0,0,961,925,1886
21,210110,2101050,لیسه علی چوپان,Ali Chopan High School,0,2,959,1223,2184
22,2201,2201001,لیسه منهاج السراج,Minhajul Seraj High School,0,0,1045,1178,2223
22,2201,2201002,لیسه امام یحی,Imam Yahya High School,0,0,2591,2188,4779
22,2201,2201003,لیسه نسوان آسیاباد,Asyabad Girls High School,0,2,1838,1367,3207
22,2201,2201004,لیسه رحمت آباد,Rahmatabad High School,0,3,2531,2845,5379
22,2201,2201005,لیسه نسوان جوزجان,Jawzjan Girls High School,0,6,3177,4094,7277
22,2201,2201006,مسجد جامع القان,Alqani Jame Mosque,0,3,1844,1540,3387
22,2201,2201007,مکتب لیسه زکور بغاوی علیا,Baghawi Ulya Boys High School,0,0,490,372,862
22,2201,2201013,لیسه نسوان بلغلی,Balghali Girls High School,0,0,420,1987,2407
22,2201,2201014,مکتب قریه قشقری,Qashqari village School,0,0,228,477,705
22,2201,2201015,لیسه انگوت ازبکیه,Angoot Uzbakiah High School,0,0,568,396,964
22,2201,2201016,لیسه بغاوی سفلی,Baghawi Sufla High School,0,0,616,744,1360
22,2201,2201017,مکتب متوسطه بغاوی اوزبیکیه,Baghawi Uzbakyah Secondary School,0,0,356,403,759
22,2201,2201018,مدرسه سنگ توده ها,Sang Tawdah ha Madrassah,0,0,576,523,1099
22,2201,2201030,مکتب ابتدائیه حد بخش,Had Bakhshi Primary School,0,0,192,164,356
22,2201,2201032,لیسه سید آباد,Sayed Abad High School,0,0,776,1248,2024
22,2201,2201033,مسجد خانقاه ملکی,Khanqah Malaki Mosque,0,16,489,1472,1977
22,2201,2201034,لیسه قوش تپه,Qush Tepah High School,0,11,471,975,1457
22,2201,2201035,لیسه شاه چنار,Shah Chinar High School,0,1,775,913,1689
22,2201,2201036,لیسه نسوان چهارباغ,Chahar Bagh Girls High School,0,1,1050,1177,2228
22,2201,2201037,لیسه قراغو,Qaragho High School,0,0,1524,1048,2572
22,2201,2201038,مکتب متوسطه کورک اوزبیکیه,Korak Uzbakyah Secondary School,0,1,1112,932,2045
22,2202,2202042,مکتب متوسطه انگشکه,Angushkah Secondary School,0,1,1793,2177,3971
22,2202,2202043,لیسه نسوان ملا سخیداد,Mulla Sakhidad Girls High School,0,0,808,977,1785
22,2202,2202044,مکتب ابتدائیه بلندغورکهنه,Billand Ghor Kuhnah Primary School,0,0,145,487,632
22,2204,2204082,لیسه محمد امی شهید,Mohammad Amin Shaheed Secondary School,0,1,497,508,1006
22,2204,2204083,مسجد جامع سوزمه قلعه ازبکیه,Sozma Qalla Uzbakiah Jame Mosque,0,1,838,577,1416
22,2204,2204084,مسجد جامع فیض آباد,Faizabad Jame Mosque,0,0,188,214,402
22,2204,2204085,مسجد سفر قشلاق,Safar Qeshlaq Mosque,0,0,331,223,554
22,2204,2204092,لیسه ذکور دوآبه,Du Aabah Boys High School,0,0,22,86,108
22,2204,2204093,مسجد جامع قریه باغ اسحق,Bagh Ishaq Village Jame Mosque,0,1,744,567,1312
22,2204,2204094,مسجد جامع سیی کلان,Sabzi Kalan Jame Mosque,0,0,183,280,463
22,2204,2204095,مکتب اسپند سای,Aspand Sai School,0,0,454,399,853
22,2205,2205097,لیسه نسوان تمی 2 تکزار,Takzar girls High School no. 2,0,0,1392,1700,3092
22,2205,2205098,مکتب متوسطه ذکور شهر کهنه تکزار,Shahr Kuhnah Takzar Boys Secondary School,0,2,793,479,1274
22,2205,2205099,مکتب متوسطه نسوان بهارک,Baharak Girls Secondary School,0,0,746,494,1240
22,2205,2205100,مسجد قریه شبوکند,Shabokand village Mosque,0,0,926,707,1633
22,2205,2205102,لیسه نسوان مسجد سی,Masjid Sab Girls High School,0,1,1382,1056,2439
22,2205,2205103,مکتب متوسطه ذکور توپخانه,Toupkhanah Boys Secondary School,0,1,692,383,1076
22,2205,2205107,مکتب متوسطه کبود آب,Kabod Aab Secondary School,0,0,262,305,567
22,2205,2205108,مدرسه قریه قشلاق کهنه,Qeshlaq Kuhnah village Madrassah,0,1,616,592,1209
22,2205,2205109,لیسه ذکور چارو,Charu Boys High School,0,0,650,432,1082
22,2205,2205110,مکتب متوسطه ذکور آق ن,Aaq Pi Boys Secondary School,0,0,262,361,623
22,2205,2205111,مکتب متوسطه فرشقان میانه,Farushqan Myanah Secondary School,0,1,566,321,888
22,2205,2205112,مسجد جامع چنار,Chinar Jae Mosque,0,1,1481,1108,2590
22,2205,2205113,مکتب متوسطه لرک,Larak Secondary School,0,15,284,375,674
22,2205,2205114,مکتب ابتدائیه قریه عرب بای,Arab Bye village Secondary School,0,0,500,644,1144
22,2205,2205115,مکتب خواجه سرخ,Khwajah Surkh School,0,0,894,794,1688
22,2205,2205116,مکتب ابتدائیه ارچه تو,Archa Tu Primary School,0,0,788,721,1509
22,2205,2205117,مکتب ابتدائیه آیدین کول,Ideen Kol Primary School,0,0,633,392,1025
22,2205,2205118,لیسه تبی و تغای خواجه,Tabeer wa Taghai Khwajah High School,0,0,1061,935,1996
22,2205,2205119,مکتب متوسطه عرفان,Irfan Secondary School,0,0,582,440,1022
22,2205,2205120,مسجد قطار درخت,Qatar Darakht Mosque,0,0,754,515,1269
22,2206,2206121,لیسه ذکور قریه قوطنمست,Qutanmast village Boys High School,0,3,945,912,1860
22,2206,2206122,مکتب متوسطه نسوان یولیاب,Yultarab Girls Secondary School,0,1,949,429,1379
22,2206,2206123,مدرسه قریه ملیکان,Malikan village Madrassah,0,0,339,471,810
22,2206,2206124,مکتب الحاقیه کران,Ilhaqya Karan School,0,1,559,578,1138
22,2206,2206125,مسجد جامع خواجهَ نهان,Khwajah Nehan Jame Mosque,0,2,802,803,1607
22,2206,2206126,مدرسه قریه شاه مرد,Shah Mard village Madrassah,0,0,590,493,1083
22,2206,2206127,مسجد قریه آبدره,Abdarah village Mosque,0,0,342,406,748
22,2206,2206128,مکتب متوسطهَ قریه آبخور,Aabkhor village Secondary School,0,0,472,501,973
22,2206,2206129,مسجد حاج سرور,Haji Sarwar Mosque,0,0,167,183,350
22,2206,2206130,مکتب متوسطه صیاد,Sayad Secondary School,0,0,518,359,877
22,2206,2206131,مسجدجامع قریه الغن,Alghan village Jame Mosque,0,0,535,750,1285
22,2206,2206132,مکتب ابتایه الغن افغانیه,Alghan Afghania Secondary School,0,758,490,682,1930
22,2206,2206133,مکتب ابتدایه مختلط شکیار,Shakyar Primary School,0,0,0,294,294
22,2206,2206134,مکتب متوسطه چغدان,Chaghdan Secondary School,0,0,5,116,121
22,2206,2206135,مسجدغجور,Ghajoor Mosque,0,1,598,577,1176
22,2206,2206136,مکتب متوسطهَ قریه کاریز,Karez village Secondary School,0,0,502,943,1445
22,2207,2207137,لیسه سید جمال الدین,Sayed Jamaluddin High School,0,0,1216,1234,2450
22,2207,2207138,مسجد خوال سیاگک,Khwal Syagak Mosque,0,2,800,684,1486
22,2207,2207139,مسجد جامع پای زیارت,Pai Zyarat Jame Mosque,0,5,1308,1244,2557
22,2207,2207140,مدرسه پیغوله,Pegholah Madrassah,0,0,1356,1124,2480
22,2207,2207141,مدرسه زوج,Zawj Madrassah,0,0,972,939,1911
22,2207,2207142,مدرسه خرماتخت,Khurma Takht Madrassah,0,0,1151,1399,2550
22,2207,2207143,مکتب قریه اوش,Owsh village School,0,2,1180,1188,2370
22,2207,2207144,لیسه شهید عارف,Shaheed Arifi High School,0,3,1394,1551,2948
22,2207,2207145,مکتب دوشاخ,Du Shakh School,0,0,934,1285,2219
22,2207,2207146,مدرسه تگاب تخت,Tagab Takht Madrassah,0,1,599,338,938
22,2207,2207147,مدرسه تل عاشقان,Tal Ashiqan Madrassah,0,1,987,693,1681
22,2207,2207148,لیسه طلوع جورازی,Tolo Jawrazi High School,0,2,1734,1896,3632
22,2207,2207149,مکتب متوسطه پیتاب,Peetab Secondary School,0,1,993,1010,2004
23,2301,2301001,لیسه نسوان دره قاض,Darah e Qazi Girls High School,0,1,869,873,1743
23,2301,2301002,لیسه سلطان علا والدین غوری,Sultan Alauddin Ghouri High School,0,20,446,2905,3371
23,2301,2301003,لیسه سلطان رضیه غوری,Sultan Razia Ghowri High School,0,2,1512,1326,2840
23,2301,2301004,لیسه نسوان میدان هوائ,Maidan Hawai Girls High School,0,1,602,498,1101
23,2301,2301005,لیسه ذکورپوزلیچ,Pozlech Boys High School,0,10,218,578,806
23,2301,2301006,مکتب متوسطه قطس سفلی,Qatas Sufla Secondary School,0,31,1162,1695,2888
23,2301,2301007,مسجدتاجکهای سرکاسی,Tajik hai Sarkasi Mosque,0,79,456,755,1290
23,2301,2301008,مکتب کاسی علیا,Kasi Ulya School,0,46,641,540,1227
23,2301,2301009,مکتب نسوان صوفک,Soufak Girls School,0,1,1065,2309,3375
23,2301,2301010,مکتب الندر,Alnader School,0,0,543,759,1302
23,2301,2301011,مسجد سوخته سفلی,Sokhtah Sufla Mosque,0,0,240,439,679
23,2301,2301012,مسجد امروتک,Amrotak Mosque,0,0,267,521,788
23,2301,2301013,مکتب نسوان عبدالمومن شهید,Abdul Momin Shaheed Girls School,0,0,688,960,1648
23,2301,2301014,مکتب آهنگران,Ahangaran School,0,0,948,1053,2001
23,2301,2301015,مکتب تغه تیمور,Tagha Taimoor School,0,1,633,1401,2035
23,2301,2301016,مکتب متوسط خواجه بهاری,Khwajah Bahari Secondary School,0,0,253,670,923
23,2301,2301017,مکتب متوسطه نسوان کندیوال,Kandiwal Girls Secondary School,0,0,928,894,1822
23,2301,2301018,مسجد دهک غوری ها,Dehak Ghori ha Mosque,0,0,355,1106,1461
23,2301,2301019,مسجدحاج عبدالحکیم,Haji Abdul Hakim Mosque,0,3,592,706,1301
23,2301,2301020,مکتب متوسطه بازار آبول,Aabul Bazar Secondary School,0,1,351,727,1079
23,2301,2301021,مسجدسرتنگ,Sar Tangi Mosque,0,6,286,1118,1410
23,2301,2301022,مسجدپله,Pullah Mosque,0,0,270,1020,1290
23,2301,2301023,کلینیک قدیمی بازارقیپ,"Raqeebi Bazar, old clinic",0,5,314,1286,1605
23,2301,2301024,مسجد خیل اعظم,Khil Azam Mosque,0,1,567,1324,1892
23,2301,2301025,مکتب فاروق شهید,Farouq Shaheed School,0,1,58,542,601
23,2301,2301026,مکتب متوسطه پهلوسنگ,Pahlo Sang Secondary School,0,0,312,823,1135
23,2301,2301027,مکتب گاشک زرتلی,Gashak Zartali School,0,0,621,823,1444
23,2301,2301028,مکتب زرتلی,Zartali School,0,0,581,760,1341
23,2301,2301029,لیسه شیخ المند,Shiekh Al Mand,0,1,760,743,1504
23,2301,2301030,مکتب متوسطه تله,Tallah Secondary School,0,2,559,532,1093
23,2301,2301031,مکتب تسراغ,Tusraghi School,0,0,349,680,1029
23,2301,2301032,لیسه محمدرسول شهید,Mohamad Rasoul Shaheed High School,0,0,223,328,551
23,2301,2301033,متوسطه محمدعمرشهید,Mohammad Omer Shaheed Secondary School,0,15,305,321,641
23,2301,2301034,متوسطه نسوان مدرسه,Girls Secondary Madrassah,0,1,514,1020,1535
23,2301,2301035,لیسه نسوان بادگاه,Badgah Girls High School,0,0,399,484,883
23,2301,2301036,مکتب متوسطه دهن تسرق,Dahan Tasruqi Secondary School,0,2,348,1048,1398
23,2301,2301058,لیسه بندر غونک,Bandar Ghawnak High School,0,0,446,743,1189
23,2301,2301059,لیسه خواجه غار,Khwajah Ghar High School,0,0,584,845,1429
23,2301,2301060,مکتب متوسطه پلو سرخ,Palaw Surkh Secondary School,0,1,960,1092,2053
23,2301,2301061,مسجد جامع بازار لخشک,Bazar Lakhshak Jame Mosque,0,1,426,1147,1574
23,2301,2301062,مسجد شوره زار سفلی,Shorah Zar Sufla Mosque,0,0,520,1328,1848
23,2301,2301063,مکتب لشکراه,Lashkarah School,0,0,284,411,695
23,2301,2301065,مکتب بره خانه,Barah Khanah School,0,0,967,1211,2178
23,2301,2301066,مسجد قریه پلال گورگ,Pelal Gorgi village Mosque,0,0,599,1164,1763
23,2301,2301067,لیسه میدان بره خانه,Maidan Barah Khanah High School,0,0,1013,1644,2657
23,2301,2301068,مسجد سنمای رخنه سفید,Sanmai Rakhna Safid Mosque,0,0,632,812,1444
23,2301,2301071,مسجد شاخ ملان,Shakh Mulan Mosque,0,0,9,175,184
23,2301,2301073,مسجد شورک کلان,Shorak Kalan Mosque,0,1,361,674,1036
23,2302,2302074,مکتب گرمابک ارباب معادالله,Arbab Ma’azullah Garmabak School,0,0,530,990,1520
23,2302,2302075,مکتب سیزار,Sairzar School,0,2,184,467,653
23,2302,2302076,مکتب نسوان,Girls School,0,0,552,1071,1623
23,2302,2302077,مسجد شوربا,Shorba Mosque,0,0,2,54,56
23,2302,2302078,مکتب اسکیچ,Iskechi School,0,1,159,289,449
23,2302,2302079,مسجد جامع خواجه گان,Khwajahgan Jame Mosque,0,1,421,488,910
23,2302,2302080,مکتب سلمی,Salmeen School,0,0,357,386,743
23,2302,2302081,مسجد رزقان,Razqan Mosque,0,0,206,165,371
23,2302,2302082,مکتب دهن غال ملا,Dahan Ghal Mulla School,0,0,256,306,562
23,2302,2302083,بازار گله آسیاب,Bazar Gellah Asyab,0,1,905,2090,2996
23,2302,2302084,مکتب برنچ,Birinji School,0,0,113,401,514
23,2302,2302085,مکتب دولینه,Duleenah School,0,0,302,540,842
23,2302,2302086,مسجد جامع شهیدان,Shaheedan Jame Mosque,0,2,723,1040,1765
23,2302,2302089,مسجد نسر گذر پهن,Nasar Guzae Pahab Mosque,0,0,861,973,1834
23,2302,2302093,مکتب غارک علیا,Gharak Ulya School,0,2,122,332,456
23,2303,2303095,لیسه اتفاق سنگ شوره,Sang Shora Itefaq High School,0,0,1111,1106,2217
23,2303,2303096,مکتب متوسطه دروازه,Darwazah Secondary School,0,0,1118,1137,2255
23,2303,2303097,مکتب لیسه نرم ته,Naram The High School,0,0,545,1127,1672
23,2303,2303098,مکتب لیسه تیل بای نظر,Tel Bye Nazar High School,0,0,529,523,1052
23,2303,2303099,آمریت معارف دو لتیار,Education Department Dawlatyar,0,8,862,864,1734
23,2303,2303100,بازار ده مرده,Band Ali Mosque,0,0,832,788,1620
23,2303,2303101,مسجد قریه علی بازار,Ali Bazar village Mosque,0,11,886,921,1818
23,2303,2303102,مکتب متوسط سنگر,Sangar Secondary School,0,1,1096,1137,2234
23,2303,2303103,لیسه ذکور پشته نور,Pushtah e Noor Boys High School,0,0,483,797,1280
23,2303,2303104,مکتب ابتدایه وزی,Wazi Primary School,0,1,102,113,216
23,2303,2303106,مسجد جامع قاض,Qazi Jame Mosque,0,0,555,549,1104
23,2303,2303107,مکتب لیسه سرسرعلیا,Shar Shar Ulya High School,0,1,544,1069,1614
23,2303,2303108,مسجد گرمابک,Garmabak Mosque,0,0,1142,1119,2261
23,2303,2303109,مسجد لوکه مزار,Lokah Mazar Mosque,0,0,323,1085,1408
23,2303,2303110,مکتب لیسه ذکور شینیه,Sheneah Boys High School,0,1,506,681,1188
23,2303,2303111,مسجد قریه گری امام داد,Gari Imamdad village Mosque,0,1,557,1128,1686
23,2304,2304115,لیسه قلعه گوهر,Qalla Gowhar High School,0,0,309,692,1001
23,2304,2304116,مسجد جامع مسی,Maseen Jame Mosque,0,0,343,714,1057
23,2304,2304120,مسجد مالمنج,Malmanj Mosque,0,0,518,994,1512
23,2304,2304121,مکتب گل تپه,Gul Tepah School,0,0,512,899,1411
23,2304,2304123,مسجد ئ فی,Nai Fatan Mosque,0,0,246,1072,1318
23,2305,2305141,مسجد وری,Wari Mosque,0,0,214,301,515
23,2305,2305142,مکتب اسپ بز,Aspi Buz School,0,1,506,440,947
23,2305,2305143,مکتب تلمستان,Talmastan School,0,1,539,586,1126
23,2305,2305144,مکتب لیسه پیتاب,Peetab High School,0,0,456,353,809
23,2305,2305151,لیسه خواجه وهاج الدین,Khwajah Wahjuddin High School,0,0,55,1391,1446
23,2306,2306154,مسجد خره سنگ,Kharah Sang Mosque,0,2,544,972,1518
23,2306,2306155,مکتب ابتدای خواجه بور,Khwajah Boor Primary School,0,7,985,2505,3497
23,2306,2306156,لیسه تنگ هلمه,Tang Helmah High School,0,2,1123,1641,2766
23,2306,2306157,مکتب دهنه تلخگ,Dahanah e Talkhaki School,0,0,786,1623,2409
23,2306,2306158,مسجد کاریز اسحاق,Karez Ishaq Mosque,0,1,293,885,1179
23,2306,2306159,مدرسه جرگ,Jarg Madrassah,0,2,265,845,1112
23,2306,2306160,مکتب ابتدای دهنه مناره,Dahanah e Minarah Primary School,0,1,452,2203,2656
23,2306,2306161,مکتب سر چشمه,Sar Chashmah School,0,0,446,788,1234
23,2306,2306162,مکتب متوسطه دهن گلبانه,Dahan Gulbanah Secondary School,0,7,538,1109,1654
23,2306,2306163,لیسه مر کز شهرک,Markaz Shahrak High School,0,1,225,745,971
23,2306,2306164,مکتب یکه بید,Yakah Bed School,0,1,770,2096,2867
23,2306,2306174,مکتب اوشان,Oshan School,0,0,7,121,128
23,2306,2306175,مسجد خم,Kham Mosque,0,0,10,111,121
23,2306,2306176,مکتب بیدان,Bedan School,0,0,558,1714,2272
23,2306,2306177,مکتب شمرغک,Shamurghak School,0,1,1051,2317,3369
23,2307,2307182,مکتب شینیه سیوار,Sheneah Sabzwar School,0,0,291,311,602
23,2307,2307183,مکتب دهن سر خک,Dahan Surkhak School,0,1,423,531,955
23,2307,2307184,مکتب سردیوالک,Sardewalak School,0,0,160,202,362
23,2307,2307185,مکتب سرقل تلخک,Sar Qul Talkhak School,0,2,255,260,517
23,2307,2307186,مکتب سرای کرمان,Sarai Kerman School,0,0,543,665,1208
23,2307,2307187,مکتب تالتو کرمان,Taltu Kerman School,0,0,223,241,464
23,2307,2307188,مکتب سفرک کرمان,Safarak Kerman School,0,1,332,447,780
23,2307,2307189,مکتب ابتدائیه سیا خاکی کرمان,Sya Khaki Kerman Primary School,0,0,0,482,482
23,2307,2307190,مکتب شور قل,Shor Qul School,0,0,333,325,658
23,2307,2307191,مسجد تگاب سعید,Tagab Sayeed Mosque,0,0,866,897,1763
23,2307,2307192,مکتب شاهی,Shahi School,0,1,357,412,770
23,2307,2307193,مکتب متوسطه باریکک,Bareekak Secondary School,0,0,214,242,456
23,2307,2307194,مکتب متوسطه شنیه سفید آب,Sheneah Safid Aab Secondary School,0,0,0,404,404
23,2307,2307195,مسجد قلعه سر آسیا گک,Qalla Sar Asya Gak Mosque,0,0,173,187,360
23,2307,2307196,مسجد سفید چشمه,Safid Chushmah Mosque,0,0,752,551,1303
23,2307,2307197,لیسه ذکور سفید آب,Safid Aab Boys High School,0,0,626,883,1509
23,2307,2307198,مسجد قلعه شهر,Qalla e Shahr Mosque,0,1,286,298,585
23,2307,2307199,مکتب شنیه چیقل,Sheneah Chapar Qul School,0,0,560,632,1192
23,2307,2307200,مکتب متوسطه سرکامران,Sar Kamran Secondary School,0,1,308,364,673
23,2307,2307201,مسجد جامع رشک,Rashk Jame Mosque,0,0,396,379,775
23,2307,2307202,مسجد قلعه شکرگ,Qalla e Shakarki Mosque,0,0,328,358,686
23,2307,2307203,لیسه امام علی,Imam Ali High School,0,0,1803,1957,3760
23,2307,2307204,مکتب قولائ,Qulani School,0,0,265,296,561
23,2307,2307205,مکتب جو قل,Joqal School,0,0,328,457,785
23,2307,2307206,مکتب الته تو,Altah Tu School,0,0,179,245,424
23,2307,2307207,مکتب ابتدائیه چشمه پادشاه,Chashmah Padshah Primary School,0,0,420,482,902
23,2307,2307208,مکتب دهن چکه,Dahan Chakah School,0,0,399,596,995
23,2307,2307209,لیسه ذکور هیگل,Heegal Boys High School,0,0,726,668,1394
23,2307,2307210,مکتب قلعه کشک,Qalla Keshk School,0,0,590,594,1184
23,2307,2307211,مکتب آب باریک,Aab Bareek School,0,1,322,401,724
23,2307,2307212,مکتب قلعه دنگک,Qalla Dangak School,0,1,350,366,717
23,2307,2307213,مکتب غیغانک,Gheeghanak School,0,0,297,381,678
23,2307,2307214,مکتب ابتدائیه منار,Minar Primary School,0,1,214,192,407
23,2307,2307215,مکتب چار آسیاب,Char Asyab School,0,0,730,882,1612
23,2307,2307216,مکتب خم شور,Kham Shor School,0,0,808,527,1335
23,2307,2307217,مکتب کته چشمه,Katah Chshmah School,0,0,661,629,1290
23,2307,2307218,مکتب سنگ زرد,Sang Zard School,0,0,720,677,1397
23,2307,2307219,مکتب بیخ سنگ,Bekh Sang School,0,0,1154,1001,2155
23,2307,2307220,لیسه سرسوخته,Sar Soukhtah High School,0,0,137,231,368
23,2307,2307221,مکتب متوسطه چشمه سیا,Chashmah Sya Secondary School,0,2,325,293,620
23,2307,2307222,مکتب گرم آب سفلی,Garm Aab Sufla School,0,0,729,666,1395
23,2307,2307223,مسجد قلعه جنگل,Qalla Jungal Mosque,0,0,172,206,378
23,2307,2307224,مکتب سنگ شانده,Sang Shandah School,0,0,248,246,494
23,2307,2307225,مکتب قزل,Qazal School,0,0,538,618,1156
23,2308,2308228,مکتب متوسطه زرئ,Zarni Secondary School,0,0,58,674,732
23,2308,2308229,مکتب متوسطه زلرگک,Zelargak Secondary School,0,2,23,500,525
23,2308,2308230,مکتب نیلی,Neeli School,0,1,213,972,1186
23,2308,2308231,متوسطه ذکوراستوان,Astwan Boys Secondary School,0,5,10,390,405
23,2308,2308232,مسجد سرکالی,Sarkali Mosque,0,0,16,309,325
23,2308,2308233,مکتب اسفور,Asfoor School,0,5,197,1176,1378
23,2308,2308234,مکتب متوسطه ذکور آنه,Aanah Boys Secondary School,0,3,92,498,593
23,2308,2308244,لیسه پس قلعه,Pas Qalla High School,0,0,532,1101,1633
23,2308,2308245,مکتب زهی نوروز,Zahi Nowroz School,0,0,561,886,1447
23,2308,2308247,مکتب عا شقان,Asheqan School,0,1,447,1237,1685
23,2308,2308248,مسجدپای حصار,Pai Hesar Mosque,0,0,132,1347,1479
23,2308,2308249,مکتب خم پای حصار,Kham Pai Hesar School,0,3,291,1131,1425
23,2308,2308250,مکتب سیب تلخ,Seb Talkh School,0,0,196,1069,1265
23,2308,2308251,مکتب نسوان لارقه,Larqah Girls School,0,0,215,844,1059
23,2308,2308252,مکتب خزبگگ,Khuzbagag School,0,0,237,800,1037
23,2308,2308253,مکتب قبه,Qubah School,0,11,560,1621,2192
23,2308,2308254,مکتب ابتدائ یگی,Yageen Primary School,0,3,133,1099,1235
23,2309,2309255,مسجد خمی,Khameen Mosque,0,2,573,2220,2795
23,2309,2309256,مکتب دورودی,Durudi School,0,4,588,2834,3426
23,2309,2309258,مکتب ابتدائیه کبوتر خان,Kabotar Khan Primary School,0,0,1752,2324,4076
23,2309,2309259,مسجید اسکوان,Askwan Mosque,0,1,583,2839,3423
23,2309,2309260,لیسه سید عبدالله علوی,Sayed Abdullah Alawi High School,0,0,125,538,663
23,2309,2309261,مکتب ابتدای سنگ خلق,Sang Khalq Primary School,0,0,243,375,618
23,2309,2309262,مکتب نسوان گلدان,Guldan Girls School,0,0,299,478,777
23,2309,2309263,مسجد جامع ده سرخ,Deh Surkh Jame Mosque,0,0,1168,1698,2866
23,2309,2309266,مکتب چهارراه تولک,Chahar Rah Tolak School,0,16,502,789,1307
23,2309,2309267,مکتب گزک,Gazak School,0,0,300,434,734
23,2310,2310275,مکتب متوسطه مناک سفلی,Manak Sufla Secondary School,0,8,190,795,993
23,2310,2310276,مکتب شیخ محمد ساغر,Shiekh Mohammad Saghar School,0,1,264,1034,1299
23,2310,2310277,کلینیک صچ,Health Clinic,0,2,756,1293,2051
23,2310,2310278,مسجد فالیی,Falizi Mosque,0,0,23,1524,1547
23,2310,2310280,مکتب متوسطه خی ناک,Khairnak Secondary School,0,0,21,555,576
23,2310,2310282,مکتب متوسطه تذری سادات,Tazri Sadat Secondary School,0,0,51,307,358
24,2401,2401001,لیسه زینبیه سنگموم,Zainabiah Sangoom High School,0,0,645,378,1023
24,2401,2401002,لیسه ذکور سنگموم,Sangoom Boys High School,0,0,724,855,1579
24,2401,2401003,مکتب نسوان سرنیلی,Sar Neeli Girls School,0,2,856,512,1370
24,2401,2401004,مکتب لیسه چهاردار,Chahardar High School,0,1,1191,1787,2979
24,2401,2401005,لیسه ذکور رباط دشت,Rubat Dasht High School,0,0,501,430,931
24,2401,2401006,مکتب هجدی,Hajdi School,0,0,257,193,450
24,2401,2401007,مکتب میش سفلی,Mesh Sufla School,0,0,244,190,434
24,2401,2401008,مسجد میش علیا,Mesh Ulya Mosque,0,0,172,155,327
24,2401,2401009,مکتب لیسه نسوان خاکباد,Khakbad Girls High School,0,0,263,143,406
24,2401,2401010,مکتب لیسه غدار,Ghadar High School,0,0,191,115,306
24,2401,2401011,مسجد پای نیلی,Pai Neeli Mosque,0,0,361,279,640
24,2401,2401012,انستیتوت مسلکی زراعت,Agriculture Vocational Institute,0,0,451,392,843
24,2401,2401013,لیسه ذکور لزیر,Lazeer Boys High School,0,0,432,347,779
24,2401,2401014,مسجد دهن عمرشه,Dahan Omersha Mosque,0,0,108,88,196
24,2401,2401015,مسجد خاک محمد,Khak e Mohammad Mosque,0,0,92,77,169
24,2401,2401016,مسجد بازار پیشوک,Peshok Bazar Mosque,0,0,192,161,353
24,2401,2401017,مکتب ذکور قول قدیر,Qul Qadeer Boys School,0,0,333,242,575
24,2401,2401018,لیسه مختلط سنگ سفید,Sang Safid High School,0,0,201,146,347
24,2401,2401019,مسجد فاطمیه,Fatimiah Mosque,0,0,205,196,401
24,2401,2401020,لیسه ذکور جرف,Jaraf Girls High School,0,0,274,210,484
24,2401,2401021,منب جوقول,Menbar e Jaw Qul,0,0,308,232,540
24,2401,2401022,مکتب نسوان شیش,Sheesh Girls School,0,0,506,406,912
24,2401,2401023,مسجد میانه قل,Myanah Qul Mosque,0,0,337,249,586
24,2401,2401024,لیسه ذکور سیوک,Sewak Boys High School,0,0,352,249,601
24,2401,2401025,مسجد خشک دره رباط,Darah e Rubat Khushk Mosque,0,0,72,78,150
24,2401,2401026,منب تلخک زار,Menbar Talkhak Bazar,0,1,270,215,486
24,2402,2402027,متوسطه ذکور اشکر آباد,Ashkarabad Boys Secondary School,0,0,225,257,482
24,2402,2402028,مسجد آشو غولکه,Asho Gholka Mosque,0,0,282,312,594
24,2402,2402029,مسجد راخان,Rakhan Mosque,0,0,108,115,223
24,2402,2402030,لیسه نسوان گبو,Geeru Girls High School,0,0,401,316,717
24,2402,2402031,ابتدائیه ث ث هاجر,Bi Bi Hajer Primary School,0,0,328,257,585
24,2402,2402032,مسجد اولک,Awlak Mosque,0,0,269,246,515
24,2402,2402033,سالن اجتماعی سید احمد,Sayed Ahmad Social Gathering Hall,0,0,391,268,659
24,2402,2402034,لیسه نسوان مملوق,Mamlooq Girls High School,0,0,447,388,835
24,2402,2402035,لیسه ذکور جنگلگ,Jangalak Boys High School,0,1,263,255,519
24,2402,2402036,لیسه عالی ذکور چباسک,Chabrasak Boys High School,0,0,205,293,498
24,2402,2402037,لیسه نسوان غاف,Ghaf Girls High School,0,0,445,435,880
24,2402,2402038,لیسه نسوان فیض آباد,Faizabad Girls High School,0,0,360,344,704
24,2402,2402039,لیسه نسوان غوچان,Ghochan Girls High School,0,0,419,347,766
24,2402,2402040,لیسه تگگ,Tagag High School,0,0,353,315,668
24,2402,2402041,مکتب ابتدائیه ذکور خوجه چاشت,Khwajah Chesht Boys Primary School,0,0,212,199,411
24,2402,2402042,لیسه ذکور القان,Alqan Boys High School,0,0,376,329,705
24,2402,2402043,مکتب ابتدایه پای مهر,Pai Mahar Primary School,0,0,224,223,447
24,2402,2402044,لیسه نسوان ث ث نرجس کتوت,Bi Bi Nargis Katoot Girls High School,0,0,386,344,730
24,2402,2402045,لیسه نسوان بنت الهدا,Bintul Huda Girls High School,0,0,438,415,853
24,2402,2402046,مکتب ورس,Waras School,0,1,383,339,723
24,2402,2402047,مسجید آب بخش غاسور,Aab Bakhsh Ghasoor Mosque,0,0,288,238,526
24,2402,2402048,مسجد صاحب الزمان خاک شاهی,Sahib ul Zaman Khak Shahi Mosque,0,0,269,321,590
24,2402,2402049,لیسه نسوان فاطمه الزهرا,Fatimatul Zahra Girls High School,0,0,418,357,775
24,2402,2402050,لیسه نسوان نورالهدا چوکشهر,Noorul Huda ChowkShahr Girls High School,0,0,226,184,410
24,2402,2402051,لیسه نسوان ورغه,Wargha Girls High School,0,0,328,308,636
24,2402,2402052,مکتب شنیه جوز,Shaneah Jawz School,0,0,347,268,615
24,2402,2402053,مسجد دهن ده اوشو,Dahan Deh Osho Mosque,0,0,315,264,579
24,2402,2402054,مسجد سفید پشته,Safid Pushtah Mosque,0,0,309,255,564
24,2402,2402055,مسجد پیتاب لرگر,Peetab Largar Mosque,0,0,368,322,690
24,2402,2402056,مسجد پلالیچ,Palaleech Mosque,0,0,427,382,809
24,2402,2402057,مسجد تگاب لرگر,Tagab Largar Mosque,0,0,380,341,721
24,2402,2402058,مسجد تگاب غیب,Tagab Ghaibi Mosque,0,0,261,291,552
24,2402,2402059,مسجد چاه,Chah Mosque,0,0,227,307,534
24,2402,2402060,لیسه ذکور صد خانه چار اسپان,Sad Khanah Char Aspan Boys High School,0,0,400,283,683
24,2402,2402061,لیسه نسوان برلان,Barlan Girls High School,0,0,660,489,1149
24,2402,2402062,مسجید زوجوک,Zojok Mosque,0,6,335,347,688
24,2402,2402063,مسجید اوری مزار ازموک,Awri Mazar Azmok Mosque,0,0,104,103,207
24,2402,2402064,مسجد شالج,Shalaj Mosque,0,0,274,252,526
24,2402,2402065,مسجد ازموک,Azmok Mosque,0,0,443,340,783
24,2402,2402066,لیسه ذکور شنیه,Shaneah Boys High School,0,2,315,128,445
24,2402,2402067,مسجید تگاب بالا قول,Tagab Bala Qul Mosque,0,0,224,216,440
24,2402,2402068,متوسطه ذکور شیونه قول,Shewnah Qul Boys Secondary School,0,0,298,294,592
24,2402,2402069,مسجید پشته جوی آمیج,Pushtah Joi Amej Mosque,0,0,216,176,392
24,2402,2402070,لیسه نسوان صرف,Saraf Girls High School,0,1,54,405,460
24,2403,2403071,مسجد کندیر لوره شیو,Kandeer Lorah Shew Mosque,0,1,345,343,689
24,2403,2403072,لیسه ذکور تگاب دار,Tagab Dar Boys High School,0,0,225,243,468
24,2403,2403073,مسجد رباط تر لوره شیو,Rubat Tar Lorah Shew Mosque,0,0,317,269,586
24,2403,2403074,کلینک زین لوره شیو,Zain Lorah Shew Clinic,0,0,885,730,1615
24,2403,2403075,صالون اجتماعی ماش زری تگابدار,Mash Zari Tagab Dar Saloon (Social Hall),0,0,321,317,638
24,2403,2403076,مسجد سهور تگاب دار,Sahwar Tagab Dar Mosque,0,0,187,260,447
24,2403,2403077,لیسه ذکور ببی,Beeri Boys High School,0,0,727,471,1198
24,2403,2403078,مسجد کاریزک ببی,Karezak Beeri Mosque,0,0,417,364,781
24,2403,2403079,مسجد جامع دیار سرتگاب,Deyar Sar Tagab Jame Mosque,0,0,20,175,195
24,2403,2403080,لیسه سرنج فخور,Saranj Fakhoor High School,0,0,563,411,974
24,2403,2403081,لیسه حسیب قخور,Hussain Qakhoo High School,0,0,1034,635,1669
24,2403,2403083,لیسه سید جماالدین افغان تمزان,"Sayed Jamaluddin Afghan High School, Tamzan",0,0,432,385,817
24,2403,2403084,لیسه فاطمه الزهرا وگب,"Fatimatul Zahra High School, Wageer",0,1,445,339,785
24,2404,2404085,شفاخانه بند پشدرم,Band e Pushdaram Hospital,0,0,288,202,490
24,2404,2404086,مسجدچهارده معصوم کمان,Chahardah Masoom Kaman Mosque,0,0,328,302,630
24,2404,2404087,مسجد امام حسن مجتب لوران خوشک,"Imam Hasan Mujtaba Mosque, Luran Khushk",0,0,272,301,573
24,2404,2404088,لیسه ذکور نوجوک,Nawjok Boys High School,0,0,281,214,495
24,2404,2404089,مسجد دهن ده یک,Dahan Deh Yak Mosque,0,0,279,283,562
24,2404,2404090,لیسه ذکور قوچنق,Quchanqi Boys High School,0,1,309,251,561
24,2404,2404091,مسجد سرخ جوی,Surkh Joi Mosque,0,0,177,139,316
24,2404,2404092,مسجد امام سجاد تالیج,Imam Sajad Taleej Mosque,0,0,331,292,623
24,2404,2404093,مکتب آزادی خوشگ,Azadi Khoshag School,0,0,312,297,609
24,2404,2404094,مسجد صاحب الزمان,Sahibul Zaman Mosque,0,0,168,161,329
24,2404,2404095,لیسه ذکور نگلیج,Negleej Boys High School,0,0,365,343,708
24,2404,2404096,مسجد سنگ محکم,Sang Mahkam Mosque,0,1,183,150,334
24,2404,2404097,مسجد قولیله عبدی,Quleelah e Abdi Mosque,0,0,155,99,254
24,2404,2404098,مسجد حضت سلمان مسروک,Hazrat Salman Masrook Mosque,0,0,251,209,460
24,2404,2404099,مسجد امام سجاد آهنگر,Imam Sajad Ahingar Mosque,0,0,105,90,195
24,2404,2404100,مسجد میانه غوچان,Myanah Ghochan Mosque,0,0,128,101,229
24,2404,2404101,لیسه ذکور سیا ناهور,Sya Nahoor Boys High School,0,0,209,197,406
24,2404,2404102,لیسه امام صادق فهرستان,Imam Sadeq Fahrestan High School,0,0,274,221,495
24,2404,2404103,مسجد سفید سنگ,Safid Sang Mosque,0,1,536,411,948
24,2404,2404104,مدرسه سر تاله,Sar Talah Madrassah,0,0,425,383,808
24,2404,2404105,مکتب متوسطه ذکورمیانه اشبلی,Myanah Ishtarli Boys Secondary School,0,0,410,383,793
24,2404,2404106,لیسه ذکور رنگ درخت,Rang Derakht Boys High School,0,1,286,323,610
24,2404,2404107,مسجد سبگلی,Sabz Galli Mosque,0,0,168,225,393
24,2404,2404108,لیسه ذکورچاوش,Chawesh Boys High School,0,3,279,321,603
24,2404,2404109,مسجدامام جعفرصادق جنگان خورد,Imam Jafar Sadeq Jangan Khord Mosque,0,1,297,287,585
24,2404,2404110,مسجد نو قلعه کرم زارجنگان,Qalla e Karam Zarjangan new Mosque,0,0,174,151,325
24,2404,2404111,مسجد امام رضا جنگان,Imam Raza Jangan Mosque,0,0,250,246,496
24,2404,2404112,مسجد رسالت چکه جنگان,Resalat Chakah Jangan Mosque,0,1,170,109,280
24,2404,2404113,مسجد چهارده معصوم ککرگ,Chahardah Masoum Kakrag Mosque,0,0,272,252,524
24,2404,2404114,مسجد دهن خولگگ,Dahan Kholgag Mosque,0,0,101,153,254
24,2404,2404115,متوسطه ذکور سیوک سیا دره,Sewak Sya Darah Secondary School,0,1,427,350,778
24,2404,2404116,لیسه ذکور کورگه سفلا,Korgah Sufla Boys High School,0,0,354,334,688
24,2404,2404117,لیسه ذکور شیلان کورگه,Shelan Korgah Boys High School,0,0,412,322,734
24,2405,2405118,مسجدجوزکیان,Jawzakyan Mosque,0,0,266,202,468
24,2405,2405119,مکتب ویب,Weer School,0,0,414,335,749
24,2405,2405120,مکتب مختلط کیان,Kyan Boys and Girls School,0,0,457,319,776
24,2405,2405121,مکتب سیاه بند پشبوق,Syah Band Peshtroq School,0,0,496,407,903
24,2405,2405122,مکتب پیتابک کورگه,Petabak Korgah School,0,0,613,564,1177
24,2405,2405123,مکتب کرس کورگه,Karas Korgah School,0,0,183,158,341
24,2405,2405124,مسجد سراب سنگ چلک,Sarab Sang Chalak Mosque,0,1,250,265,516
24,2405,2405125,مسجد شینیه خدیر علیا,Sheneah Khadeer Ulya Mosque,0,0,418,365,783
24,2405,2405126,مکتب متوسطه سرقل خدیر,Sar Qul Khadeer Secondary School,0,0,205,167,372
24,2405,2405127,مسجد خدیر سفلی,Khadeer Sufla Mosque,0,0,259,320,579
24,2405,2405128,مسجد شنیه جلیل پسی بند,Shaneah Jalil Pasiband Mosque,0,0,203,177,380
24,2405,2405129,مکتب دهن سای پسی بند,Dahan Sai Pasi Band School,0,0,346,284,630
24,2405,2405130,مسجد پیتاب جوی شلغم,Peetab Joi Shalgham Mosque,0,0,392,397,789
24,2405,2405131,مکتب آبدره غم قل,Abdarah Gham Qul School,0,0,231,202,433
24,2405,2405132,مسجد دیکتور خبخانه,Dector Khairkhana Mosque,0,0,291,227,518
24,2405,2405133,مکتب ابتدائیه نسوان دهن کیب,Dahan Keeti Girls Primary School,0,1,192,176,369
24,2405,2405134,مکتب دهن غم قل,Dahan Gham Qul School,0,0,238,182,420
24,2405,2405135,مکتب لیسه گزببی,Gazbeeri High School,0,0,376,300,676
24,2405,2405136,مکتب علی آباد آبیگگ,Ali Abad Abegag School,0,0,78,77,155
24,2405,2405137,مکتب دهن سرخ قولک,Dahan Surkh Qolak School,0,1,460,441,902
24,2405,2405138,مسجد بازار کیب,Bazar Keeti Mosque,0,0,197,183,380
24,2405,2405139,لیسه ذکور شکر دره,Shakardarah Boys High School,0,0,121,383,504
24,2405,2405140,مکتب دستب,Dastani School,0,0,538,401,939
24,2405,2405141,مسجد کمور,Kamoor Mosque,0,0,44,130,174
24,2405,2405142,مکتب چاغان,Chaghan School,0,0,120,106,226
24,2405,2405143,مسجد خاک فقب,Khak Faqeer Mosque,0,0,195,132,327
24,2405,2405144,مسجد قریه بزی,Buzi village Mosque,0,1,281,189,471
24,2405,2405145,مسجد دیکتور,Dector Mosque,0,0,259,150,409
24,2405,2405146,مسجد کالوه,Kalwah Mosque,0,2,669,631,1302
24,2406,2406147,مکتب سر کیسو,Sar Keeso School,0,0,1159,647,1806
24,2406,2406148,مکتب غوله کیسو,Gholah Keeso School,0,1,419,312,732
24,2406,2406149,مسجد سر باغ کیسو,Sarbagh Keeso Mosque,0,0,880,564,1444
24,2406,2406150,مسجد سروع کیسو,Shuru Keeso Mosque,0,0,603,447,1050
24,2406,2406151,مسجد رویان,Royan Mosque,0,0,554,396,950
24,2406,2406152,مسجد کومی,Hoshi Mosque,0,0,515,308,823
24,2406,2406153,مسجد مونمی,Monami Mosque,0,0,344,176,520
24,2406,2406154,مکتب شنیه کیب,Shneah Keeti School,0,1,734,424,1159
24,2406,2406155,مکتب تمران,Tamran School,0,3,1432,816,2251
24,2406,2406156,مکتب سرتمران,Sar Tamaran School,0,0,408,267,675
24,2406,2406157,مسجد هوش,Komi Mosque,0,0,293,229,522
24,2406,2406158,مکتب سنگینک,Sangeenak School,0,0,510,297,807
24,2406,2406159,مکتب خرنیک,Kharnek School,0,0,292,225,517
24,2406,2406160,مکتب حضت مصطق,Hazrat Mustafa School,0,0,300,170,470
24,2406,2406161,مسجد شالبار,Shalizar Mosque,0,0,604,384,988
24,2406,2406162,مکتب کاروان سرای,Karwan Sarai School,0,0,458,232,690
24,2406,2406163,مکتب پنور,Panor School,0,0,632,302,934
24,2406,2406164,مکتب کورنگگ,Korangag School,0,0,274,177,451
24,2406,2406165,مکتب موزرمی,Mozarmi School,0,0,320,207,527
24,2406,2406166,مسجد سرتغان,Sartaghan Mosque,0,0,632,382,1014
24,2406,2406167,مسجد تجریب,Tajreeb Mosque,0,1,385,263,649
24,2406,2406168,مسجد غرینج,Ghareenj Mosque,0,0,506,292,798
24,2406,2406169,مسجد ارگان,Urgan Mosque,0,0,471,292,763
24,2407,2407170,مسجد آث زوار علی,Zawar Ali Aabi Mosque,0,0,153,0,153
24,2407,2407171,مسجد غچورک,Ghachoorak Mosque,0,0,315,171,486
24,2407,2407172,مسجد تندک نیک,Tundak Nek Mosque,0,0,347,201,548
24,2407,2407173,مکتب سرقول نیک,Sar Qul Nek Aabi,0,0,316,194,510
24,2407,2407174,مکتب خواجه غار,Khwajah Ghar School,0,0,178,144,322
24,2407,2407175,مکتب تسلیچ,Tasleech School,0,0,160,152,312
24,2407,2407176,لیسه زکور نهال,Nehal Boys High School,0,0,697,433,1130
24,2407,2407177,مکتب دهن قول,Dahan Qul School,0,0,153,105,258
24,2407,2407178,لیسه زکور چهار صد خانه,Chahar Sad Khanah Boys High School,0,0,696,497,1193
24,2407,2407179,مسجد ناک سفلی,Naak Sufla Mosque,0,0,354,221,575
24,2407,2407180,لیسه زکور وطنه,Watanah Boys High School,0,1,371,318,690
24,2407,2407181,مسجد بند باریک نرخسی,Band e Bareek Narkhesi Mosque,0,0,415,343,758
24,2407,2407182,مسجد دو جهان تیکان برکر,Du Jehan Tekan Barkar Mosque,0,0,217,160,377
24,2407,2407183,مکتب شینیه برکر,Sheneah Barkar School,0,0,587,357,944
24,2407,2407184,مکتب دهن درراه,Dahan Dar Rah School,0,1,318,256,575
24,2407,2407185,مسجد ث برکر,Tai Barkar Mosque,0,0,266,238,504
24,2407,2407186,مسجد بردیز,Bardez Mosque,0,1,234,170,405
24,2407,2407187,مکتب کوراف اسبک,Koraf Asterak School,0,0,142,146,288
24,2407,2407188,مکتب سنگان,Sangan School,0,0,334,265,599
24,2407,2407189,مسجد زیمرا فولاد,Zemra Folad Mosque,0,0,178,157,335
24,2407,2407190,مکتب نسوان ث ورسیل,Tai Warseel Girls School,0,0,339,292,631
24,2407,2407191,مکتب نسوان سرخ جوی رباط,Surkh Joi Rubat Girls School,0,0,535,470,1005
24,2407,2407192,مکتب کلان قول رباط,Kalan Qul Rubat,0,0,150,122,272
24,2407,2407193,مکتب چهارشنبه,Chahar Shanbah School,0,0,161,178,339
24,2407,2407194,مسجد سیاه بومک رباط,Syah Bomak Rubat Mosque,0,1,220,190,411
24,2407,2407195,مسجد قریه گرگ,Gurgi village Mosque,0,0,301,242,543
24,2407,2407196,مسجد وربرگوت,Warbargot Mosque,0,0,416,356,772
24,2407,2407197,مکتب اونه برگر,Ownah Burger School,0,0,408,329,737
24,2407,2407198,مسجد بازار جوز,Bazar Jawz Mosque,0,0,461,400,861
24,2407,2407199,مکتب شیدان چرخ,Shaeedan Charkh School,0,1,741,608,1350
24,2407,2407200,مکتب جوی توت,Joi Toot School,0,0,376,331,707
24,2407,2407201,مسجد میانه نالچ,Myanah Nalach Mosque,0,0,676,481,1157
24,2407,2407202,مکتب ذکور تخاوی,Takhawi Boys School,0,1,545,429,975
24,2407,2407203,مسجد پتاب قنغور,Patab Qanghoor Mosque,0,0,137,116,253
24,2407,2407204,مسجد زاغ مرده سرقول,Zaagh Murdah Sar e Qul Mosque,0,0,137,126,263
24,2407,2407205,مکتب تگاب,Tagab School,0,1,613,559,1173
24,2407,2407206,مسجد باغ علیا,Bagh Ulya Mosque,0,1,342,281,624
24,2407,2407207,مسجد اروس علیا,Uroos Ulya Mosque,0,0,192,132,324
24,2407,2407208,مکتب نسوان اسکان,Askan Girls School,0,0,647,508,1155
24,2407,2407209,مسجد تقمان دره,Tuqman Darah Mosque,0,0,213,174,387
24,2407,2407210,مکتب یکه ومونته,Yaka wa Montah School,0,0,133,89,222
24,2407,2407211,مسجد راکو,Rako Mosque,0,0,429,327,756
24,2407,2407212,مسجد آزرکه مبغلام,Aazrakah Mir Ghulam Mosque,0,0,397,286,683
24,2407,2407213,مسجد ث جنگ,Tai Jang Mosque,0,1,500,345,846
24,2407,2407214,مسجد شینه اشتو,Sheenah Ashtu Mosque,0,1,566,359,926
24,2408,2408215,لیسه تلخک شیخ علی,Talkhak Shiekh Ali High School,0,0,248,243,491
24,2408,2408216,مسجد قلعه سنگ,Qalla Sangi Mosque,0,1,429,392,822
24,2408,2408217,مسجد جامع امب المومنی,Amirul Momineen Jame Mosque,0,0,112,157,269
24,2408,2408218,لیسه سیاه ده,Syah Deh High School,0,0,126,130,256
24,2408,2408219,مسجد سبک,Seerak Mosque,0,0,191,184,375
24,2408,2408220,مکتب شینیه قرامت,Sheneah Qeramat School,0,1,228,198,427
24,2408,2408221,مسجد ایل,Ael Mosque,0,0,218,208,426
24,2408,2408222,منب دهن غرغره,Menbar Dahan Ghar Gharah,0,0,173,174,347
24,2408,2408223,لیسه دارالهدا,Darul Huda High School,0,0,228,276,504
24,2408,2408224,مسجد جعفریه بازارسنگ تخت,Bazar Sang Takht Jafaria Mosque,0,0,578,628,1206
24,2408,2408225,منب ارگ,Menbar Arg,0,0,232,205,437
24,2408,2408226,منب قطقطی,Menbar Qutquti,0,0,679,587,1266
24,2408,2408227,مسجد شینیه چکه,Sheneah Chakah Mosque,0,2,401,353,756
24,2408,2408228,لیسه سر قد,Sar Qad High School,0,0,254,220,474
24,2408,2408229,منب دهن دل دل,Menbar Dahan Dal Dal,0,0,380,344,724
24,2408,2408230,مسجد امام سجاد,Imam Sajad Mosque,0,1,271,275,547
24,2408,2408231,لیسه دهن برغس,Dahan Barghas High School,0,0,233,271,504
24,2408,2408232,مکتب بازار سیاه چوب,Syah Chob Bazar School,0,0,603,448,1051
24,2408,2408233,لیسه چهار قول مبی,Chahar Qul Miri High School,0,0,444,315,759
24,2408,2408234,مسجد شینیه قلعه,Sheneah Qalla School,0,0,508,506,1014
24,2408,2408235,مکتب بازار سلبیتو,Salbeetu Bazar School,0,1,702,701,1404
24,2408,2408236,لیسه بعثت مرکز بندر,"Markaz Bandar, Ba’asat High School",0,0,362,362,724
24,2408,2408237,مسجد عمومی اسب دوان,Asb Dawan General Mosque,0,0,284,255,539
24,2408,2408238,لیسه ذکور مباث علیا,Meerasi Ulya Boys High School,0,0,542,482,1024
24,2409,2409240,مسجد جامع بوکا,Boka Jame Mosque,0,3,1155,385,1543
24,2409,2409241,منب زردگلان,Menbar e Zard Gulan,0,2,724,686,1412
24,2409,2409242,منب سرخ سرک,Menbar e Surkh Sarak,0,1,380,314,695
24,2409,2409243,مسجد قاسم آباد,Qasim Abad Mosque,0,0,377,308,685
24,2409,2409244,مسجد باغبان,Baghban Mosque,0,0,441,325,766
24,2409,2409245,منب دوازده امام خوجو,Menbar e Dwazadah Imam Khujo,0,0,231,214,445
24,2409,2409246,مکتب متوسطه سنگ شهرک,Sang Shahrak Secondary School,0,0,338,220,558
24,2409,2409247,لیسه نسوان جوی ولی عض,Joi Wali Aser Girls High School,0,2,507,383,892
24,2409,2409248,مکتب متوسطه ام گلثوم,Um Gulsoom Secondary School,0,3,520,376,899
24,2409,2409250,مسجد سليمان آباد,Sulaiman Abad Mosque,0,0,279,170,449
24,2409,2409251,مسجد جامع بوکه صوف,Bokah Souf Jame Mosque,0,0,0,386,386
24,2409,2409252,لیسه نسوان شا جوی تاجوی,Shajoi Tajoi Girls High School,0,0,660,629,1289
24,2409,2409253,مکتب لاغر جوی,Laghar Joi School,0,0,936,609,1545
24,2409,2409254,مکتب متوسطه نسوان تاخه,Takha Girls Secondary School,0,0,307,211,518
24,2409,2409255,منب سلمونج,Menbar Salmonji,0,1,111,163,275
25,2501,2501001,ليسه عالی سيدالخان,Sayed Al Khan High School,0,18,206,5625,5849
25,2501,2501003,مکتب متوسطه چرمگر,Charamgar Secondary School,0,4,0,1717,1721
25,2501,2501004,مکتب متوسطه سفيدخار,Safid Khar Secondary School,0,7,0,1926,1933
25,2501,2501005,د شورنگ مکتب,Shorang School,0,3,94,2935,3032
25,2501,2501006,دسروری مکتب,Sarwari School,0,0,227,3897,4124
25,2501,2501007,دن وب هار مکتب,Nawbahar School,0,8,0,1418,1426
25,2501,2501008,مکتب متوسطه تالان,Talani Secondary School,0,1,166,2441,2608
25,2501,2501012,د ارزگان پوهنتون,Uruzgan University,0,17,27,2141,2185
25,2501,2501013,د شیآ غا مکتب,Sher Agha School,0,0,18,824,842
25,2501,2501014,سرشخلی مکتب,Sareshkhali School,0,5,0,1827,1832
25,2501,2501022,لیسه کوټوال,Kotwal High School,0,0,0,290,290
25,2501,2501002,لیسه ملالی,Malalai High School,0,7,826,3188,4021
25,2502,2502023,لیسه بازار شهرنو,Bazar Shahr e Naw High School,0,2,34,5917,5953
25,2502,2502024,حاج احمد خان مسجد,Haji Ahmad Khan High School,0,6,0,2640,2646
25,2502,2502025,د ملا خدای نظر د کلی مکتب,Mulla Khudai Nazar village School,0,178,0,395,573
25,2502,2502026,لبلان مکتب,Lublan School,0,4,0,3494,3498
25,2502,2502027,لیسه ملا احمد,Mulla Ahmad High School,0,0,0,142,142
25,2502,2502028,د دیب سنګ کلی لیسه,Deeb Sang village High School,0,0,24,459,483
25,2503,2503031,مکتب قلعه راغ,Qalla e Ragh School,0,0,0,108,108
25,2503,2503032,مكتب زنانه دینار خیل,Dinar Khil Girls School,0,0,2,233,235
25,2503,2503033,لیسه مرکزی بازار,Markazi Bazar High School,0,0,3,113,116
25,2503,2503034,د حاج محمد اکی خان کور,Haji Mohammad Akbar Khan House,0,0,28,1668,1696
25,2503,2503035,لیسه دول ت زان,Dawlat Zaii High School,0,2,18,3440,3460
25,2506,2506053,لیسه معلم فیض محمد,Mualem Faiz Mohammad High School,0,58,0,478,536
25,2506,2506054,کلینیک زنانه,Women Clinic,0,0,0,855,855
25,2507,2507060,مسجد جامع شیان,Sheeran Jame Mosque,0,1,294,651,946
25,2507,2507063,مسجد بازار قریه نیکوزی,Nekozai village Bazar Mosque,0,3,0,2060,2063
25,2507,2507065,مسجد بازار چون,Chawnni Bazar Mosque,0,0,0,1551,1551
25,2507,2507064,مسجد بازار کهنه,Bazar Kuhnah (old bazar) Mosque,0,2,0,1599,1601
26,2601,2601001,د کاکړانو مسجد,Kakarrano Mosque,0,28,18,458,504
26,2601,2601002,اتم نمي ښوونځ,Atam number School (School no.8),0,457,172,1755,2384
26,2601,2601003,چوب مكتب,Chawnni School,0,23,91,362,476
26,2601,2601004,ولايت شفاخانه,Provincial Hospital,0,529,341,4593,5463
26,2601,2601005,ب ب خالا لیسه,Bi Bi Khala High School,0,316,967,2807,4090
26,2601,2601006,شیخ مت لیسه,Shiekh Mati High School,0,371,90,3218,3679
26,2601,2601007,کنډک مکتب,Kandak School,0,248,191,2750,3189
26,2601,2601008,مکتب نسوان رساله,Resalah Girls School,0,277,258,2220,2755
26,2601,2601009,مکتب نسوان سینک,Senak Girls School,0,59,170,1710,1939
26,2601,2601010,سورغرلیسه,Soor Ghar High School,0,247,46,951,1244
26,2601,2601011,جارو لامکتب,Jaru La School,0,184,286,2213,2683
26,2601,2601012,کگری مسجد,Kagrai Mosque,0,31,0,470,501
26,2601,2601013,مسجد نوخي,Nawkhiz Mosque,0,18,0,246,264
26,2601,2601014,خاله مسجد,Khalah Mosque,0,5,0,161,166
26,2601,2601015,سپینه غيګه مکتب,Speenah Ghbargah School,0,6,0,558,564
26,2601,2601016,خوازو کلی لوی مسجد,Khwazo Kalai (village) Loy Mosque,0,5,0,667,672
26,2601,2601017,خار جوی مکتب,Khar Joi School,0,15,0,334,349
26,2602,2602018,اغوجان کلی مسجد,Agho Jan village Mosque,0,1,0,25,26
26,2602,2602019,احمدشا بابا مکتب,Ahmad Shah Ba Ba School,0,9,0,542,551
26,2602,2602020,د هلكانو مكتب,Boys School,0,13,31,1627,1671
26,2602,2602021,درو کلی مسجد,Duru village Mosque,0,1,0,287,288
26,2602,2602022,مكتب غيش رباط,Gheshi Rubat School,0,30,137,1171,1338
26,2602,2602023,مسجد محمد جان کلی,Mohammad Jan village Mosque,0,1,0,295,296
26,2602,2602024,د جلدک روغتون,Jaldak Hospital,0,6,45,735,786
26,2602,2602025,حاج لعل جان کلی مسجد,Haji Lal Jan village Mosque,0,2,0,432,434
26,2603,2603028,شاه علم ليسه,Shah Alam High School,0,41,53,2096,2190
26,2603,2603030,مسجددب,Dab Mosque,0,0,0,246,246
26,2603,2603032,د سیوری مکتب,Sewri School,0,11,4,1118,1133
26,2603,2603100,د آخندخیل مسجد,Akhund Khil Mosque,0,4,0,332,336
26,2604,2604035,ټکي کلی مسجد,Takeer village Mosque,0,68,0,425,493
26,2604,2604039,ناوه عالم ګل مکتب,Nawah Alam Gul School,0,96,7,1477,1580
26,2605,2605052,دسرخسنګ مکتب,Surkh Sang School,0,1,0,374,375
26,2606,2606055,بابا هوتك ليسه,Ba Ba Hotak High School,0,347,0,5345,5692
26,2606,2606057,جمال خیل مکتب,Jamal Khil School,0,89,0,1535,1624
26,2606,2606058,هولان رباط کلینک,Holan Rubat Clinic,0,57,4,2228,2289
26,2606,2606059,د ننوخیلو مسجد,Nanokhilo Mosque,0,51,0,2174,2225
26,2606,2606060,مكتب غلام رباط مالند,Ghulam Rubat Maland School,0,8,25,556,589
26,2606,2606064,قره باغ مکتب,QaraBagh e School,0,163,0,2388,2551
26,2608,2608075,د کلی مسجد,Da Kali (village) Mosque,0,0,0,1436,1436
26,2609,2609078,کلینیک بابو,Babu Clinic,0,0,0,576,576
26,2610,2610083,ميويس خان مكتب,Mirwais Khan School,0,1,427,1784,2212
26,2610,2610089,كلينیك ولسوال,District Clinic,0,9,0,2276,2285
26,2610,2610091,قلعه رشید کلی,Qalla Rasheed village,0,1,0,578,579
27,2703,2703057,اجتماعی صالون,Ijtemai Saloon (Community Hall),0,53,352,652,1057
27,2703,2703058,د مرغان کیځ مکتب,Murghan Keche School,0,74,70,1425,1569
27,2703,2703059,د محمد زی مسجد,Mohammad Zai Mosque,0,2,0,281,283
27,2703,2703060,د حاج حبيب اكا مسجد,Haji Habib Aka Mosque,0,6,1,166,173
27,2703,2703061,سیملزو مسجد,Semalzo Mosque,0,197,12,945,1154
27,2703,2703062,د محمد اشف مسجد,Mohammad Ashraf Mosque,0,10,24,516,550
27,2703,2703063,د لطیف آغا مکتب,Latif Agha School,0,14,0,721,735
27,2703,2703064,مكتب اعظم قلعه,Azam Qalla School,0,152,130,1266,1548
27,2703,2703066,نساج مكتب,Nasaji School,0,240,311,1421,1972
27,2703,2703067,مكتب ښوراندام,Shor Andam School,0,203,240,1303,1746
27,2703,2703068,مكتب ناقلي,Naqeleen School,0,56,199,923,1178
27,2703,2703069,دغره دکلی مکتب,Da Ghra da Kali School,0,100,127,941,1168
27,2703,2703070,مكتب منډهسار,Mandahsar School,0,62,80,1567,1709
27,2703,2703071,د ملا عبدالله مکتب,Mulla Abdullah School,0,31,17,904,952
27,2703,2703072,مكتب خوش آب,Khosh Aab School,0,18,17,623,658
27,2703,2703073,فارم ترنك مكتب,Farm Tarank School,0,97,301,1312,1710
27,2703,2703074,د حاج سيف الله تیلو پمپ ډالی مکتب,Haji Saifullah Petrol Pump Dalai School,0,40,143,647,830
27,2704,2704075,مكتب ريګوا,Regwa School,0,26,0,1073,1099
27,2704,2704076,ناخون کلی مکتب,Nakhoni village School,0,0,46,2052,2098
27,2704,2704077,مكتب چهل غور,Chehel Ghowr School,0,5,11,1157,1173
27,2704,2704078,دمعلولینومکتب,Persons with Disability School,0,45,375,1448,1868
27,2704,2704079,مسجد صالحان,Salehan Mosque,0,27,83,1374,1484
27,2704,2704080,مكتب سلوات,Salwat School,0,101,0,2351,2452
27,2704,2704081,د ملا عبدالرحمن دربار مسجد,Mulla Abdul Rahman Darbar Mosque,0,15,0,862,877
27,2704,2704082,د شمس الدين كاكر مكتب,Shamsuddin Kakarr School,0,36,135,2252,2423
27,2704,2704083,د حاج عبدالله خان مكتب,Haji Abdullah Khan School,0,19,6,1626,1651
27,2704,2704084,سليمان ماكو مكتب,Sulaiman Mako School,0,17,0,1756,1773
27,2704,2704085,سلطان محمد خان مكتب,Sultan Mohammad Khan School,0,7,42,1069,1118
27,2704,2704086,محمد جان كمپ,Mohammad Jan Camp,0,2,0,652,654
27,2704,2704087,د ټالکان کلی مكتب,Talkan village School,0,6,49,1383,1438
27,2704,2704088,د ملا حسن ليسه,Mulla Hassan High School,0,14,22,1862,1898
27,2704,2704089,محمد زو مسجد,Mohammad Zu Mosque,0,15,0,1840,1855
27,2704,2704090,د بازار مدرسه,Bazar Madrassah,0,0,0,1867,1867
27,2705,2705091,مكتب نلغام,Nalgham School,0,1,0,4238,4239
27,2705,2705092,حاج پبمحمد مسجد,Haji Peer Mohammad Mosque,0,25,0,3764,3789
27,2705,2705093,زوړ كلينيك,Old Clinic,0,222,95,2034,2351
27,2705,2705094,ګړندی اخندزاده ابتدایه ښوونځ,Grrandai Akhundzadah Primary School,0,162,0,1039,1201
27,2705,2705095,د امان الله مكتب,Amanullah School,0,6,0,1008,1014
27,2705,2705096,د قلق مکتب,Qulaq School,0,8,0,1222,1230
27,2705,2705097,د پاشمول کلی مكتب,Pashmol village School,0,6,0,1458,1464
27,2705,2705098,شبمحمد هوتک ښوونځ,Sher Mohammad Hotak School,0,166,91,2715,2972
27,2705,2705099,مكتب عاشقه,Ashiqa School,0,88,0,1011,1099
27,2705,2705100,پبمحمد کاکړلیسه,Peer Mohammad Kakar High School,0,26,194,4166,4386
27,2705,2705101,د پوپل نيكه مكتب,Popal Nekah School,0,11,0,1352,1363
27,2705,2705102,څلورم كمپ مسجد,Salouram camp Mosque (Camp no. 4 Mosque),0,32,0,1108,1140
27,2705,2705103,دریم کمپ مکتب,Camp no. 3 Mosque,0,40,0,516,556
27,2705,2705104,دوهم كمپ مسجد,Camp no. 2 Mosque,0,33,0,1085,1118
27,2705,2705105,اول كمپ خیمه,Awal camp (camp no. 1) tent,0,92,0,2469,2561
27,2705,2705106,يولسم كمپ ښوونځ,Camp no. 11 School,0,0,0,8,8
27,2706,2706107,مكتب سيد حليم,Sayed Halim School,0,34,0,1041,1075
27,2706,2706110,مسجددامانه,Damanah Mosque,0,122,63,1472,1657
27,2706,2706112,كلينيك ويان,Wyan Clinic,0,208,0,962,1170
27,2707,2707119,د ولسوالی اداري تعمب,District Administrative Building,0,0,32,373,405
27,2707,2707120,د خاکریز کلی كلينيك,Khakrez village Clinic,0,0,0,4,4
27,2708,2708128,دټيسن كلی مكتب,Tessan Village School,0,0,0,561,561
27,2708,2708129,مكتب تيسان كلی,Tessan village School,0,0,0,587,587
27,2708,2708130,غبگ کلی مسجد,Ghbarge village Mosque,0,0,104,566,670
27,2708,2708131,مكتب بالا كرزي,Bala Karzai School,0,2,0,1089,1091
27,2708,2708132,محمد نيكه مكتب,Mohammad Nekah School,0,7,0,1632,1639
27,2708,2708133,هرم زای مسجد,Haram Zai Mosque,0,18,0,554,572
27,2708,2708134,باتوخیل مسجد,Batukhil Mosque,0,0,0,222,222
27,2708,2708135,مسجد سپي اګره,Speen Agrah Mosque,0,0,0,1062,1062
27,2708,2708136,مسجد شنه خته,Shnah Khatah Mosque,0,0,0,578,578
27,2708,2708137,مكتب امي قلعه,Ameen Qalla School,0,2,2,640,644
27,2708,2708138,بابره کلی حاج نیک محمدمسجد,"Babrah village, Haji Nek Mohammad Mosque",0,1,0,523,524
27,2708,2708139,نارغال غټ مسجد,Narghal Ghat Masjid Mosque,0,1,0,1080,1081
27,2709,2709141,مسجد پبخادم,Peer Khadim Mosque,0,1,0,563,564
27,2713,2713189,مسجد غلينګ,Ghuling Mosque,0,1,0,908,909
27,2710,2710146,د ملا ابراهيم مكتب,Mulla Ibrahim School,0,23,0,1156,1179
27,2710,2710149,د غازي محمد ايوب خان ليسه,Ghazi Mohammad Ayub Khan High School,0,39,80,3918,4037
27,2710,2710150,د ولسوالی مركز,District Center,0,13,79,2791,2883
27,2711,2711156,غین نیکه مکتب,Ghaibi Nekah School,0,3,192,1411,1606
27,2711,2711157,جلال مکتب,Jalal School,0,3,497,3885,4385
27,2711,2711158,حاج ظاهر مکتب,Haji Zahir School,0,48,1127,2793,3968
27,2711,2711159,د عالی نیکه مكتب,Aali Nekah School,0,31,528,3396,3955
27,2711,2711160,حاج رازق دارالمعلمي,Haji Raziq Darul Malemeen (Teacher Training),0,12,573,1178,1763
27,2711,2711161,ویش کلینک صځ مرکز,Wesh Clinic Health Center,0,29,490,3309,3828
27,2711,2711162,ملک کبب مکتب,Malik Kabir School,0,17,295,3744,4056
27,2711,2711163,بازمحمد مکتب,Baz Mohammad School,0,40,382,3405,3827
27,2711,2711164,معلم سعدالله لیسه,Malem Sadullah High School,0,8,213,2024,2245
27,2711,2711165,حاج فیض محمد مکتب,Haji Faiz Mohammad School,0,78,1072,3502,4652
27,2711,2711166,حاج رازق مکتب,Haji Raziq School,0,136,1086,4404,5626
27,2711,2711167,امام ابوحنیفه مکتب,Imam Abu Haneefah School,0,4,398,2779,3181
27,2711,2711168,د غازي عبدالله خان لیسه,Ghazi Abdullah Khan High School,0,134,388,3760,4282
27,2711,2711169,حاج شاه محمود مکتب,Haji Shah Mahmoud School,0,36,506,3806,4348
27,2711,2711170,نواباد مکتب,Nawabad School,0,143,379,3797,4319
27,2711,2711171,نعمت مکتب,Nemat School,0,128,84,2429,2641
27,2711,2711172,سیدولی مکتب,Sayed Wali School,0,130,69,1105,1304
27,2711,2711173,حځ بصب مکتب,Haji Basir School,0,305,448,3364,4117
27,2711,2711174,مرغه مکتب,Margha School,0,15,528,2067,2610
27,2711,2711175,قاض مدرسه,Qazi Madrassah,0,132,437,2617,3186
27,2711,2711176,د لوي كاريز كلينيك,Loy Karez Clinic,0,8,499,3253,3760
27,2711,2711177,د شهيد عبدالله جان مكتب,Shaheed Abdullah Jan School,0,8,446,452,906
27,2711,2711178,اخب زي لوي كلی,Akhtar Zi Loy Kalai village,0,10,471,2802,3283
27,2711,2711179,د حاج محمد ايوب مكتب,Haji Mohammad Ayub School,0,9,225,879,1113
27,2711,2711180,د عبدالصمد خان مكتب,Abdul Samad Khan School,0,331,0,3046,3377
27,2711,2711181,د زړی قلعه مکتب,Old village School,0,217,468,3059,3744
27,2714,2714195,د ولی محمد خان كور,Wali Mohammad Khan House,0,4,0,199,203
27,2716,2716204,مكتب شبشاه,Sher Shah School,0,13,0,148,161
27,2717,2717206,روح اباد مکتب,Rouh Abad School,0,731,271,2637,3639
27,2717,2717207,د روان منځن ښوونځ,Rawnni Secondary School,0,18,171,2210,2399
27,2717,2717208,خواجه علی ابتدایه,Khwaja Ali Primary School,0,19,97,1704,1820
27,2717,2717209,د ذاكر شیف مكتب,Zakir Sharif School,0,100,634,3474,4208
27,2717,2717210,بلدي منځن ښوونځ,Baldi Secondary School,0,67,94,1246,1407
27,2717,2717211,د كلچه آباد منځن ښوونځ,Kulcha Abad Secondary School,0,30,58,1161,1249
27,2717,2717212,جمال کرز لیسه,Jamal Karz High School,0,123,173,2813,3109
27,2717,2717213,مکتب ده باغ,Deh Bagh School,0,101,139,2521,2761
27,2717,2717214,بلندی مکتب,Bilandi School,0,23,224,2071,2318
27,2717,2717215,مکتب چپلان,Chaplani School,0,15,270,2038,2323
27,2718,2718217,مدد خان مكتب,Madad Khan School,0,194,350,1856,2400
27,2718,2718218,دحاج طالب اكا كور,Haji Talib Aka House,0,8,257,2576,2841
27,2718,2718220,د تنګ کلی روزد ته نژدي خیمه,Tents near the Tangi village Rawzah,0,68,281,2618,2967
27,2718,2718222,د ولسوالی مرکز,District Center,0,1,186,950,1137
27,2718,2718223,د کلی منځن ښوونځ,Village Secondary School,0,0,262,459,721
27,2718,2718224,غټ مكتب,Ghat Maktab School,0,0,390,600,990
27,2718,2718225,حسن زی مکتب,Hasan zai School,0,0,41,277,318
27,270103,2701016,شي غزی بابا مکتب,Sheen Ghazai Ba Ba School,0,227,1909,5295,7431
27,270104,2701017,دارالمعلمي,Teacher Training Institute,0,90,1644,6697,8431
27,270104,2701018,شهيد عبدالطيف لیسه,Shaheed Abdul Latif High School,0,46,919,5309,6274
27,270104,2701019,مبويس نيكه لیسه,Mirwais Nekah High School,0,106,745,6793,7644
27,270104,2701020,د ملالی ليسه,Malalai High School,0,22,1102,5741,6865
27,270104,2701021,احمدشاه بابا مدرسه,Ahmad Shah Ba Ba Madrassah,0,133,0,9965,10098
27,270104,2701022,تيمورشاهی لیسه,Temoor Shahi High School,0,126,973,6415,7514
27,270105,2701023,د حاج نیکه مکتب,Haji Nekah School,0,937,751,4834,6522
27,270106,2701024,د عبدالهادي داوي منځن ښوونځ,Abdul Hadi Dawi Secondary School,0,13,559,3435,4007
27,270106,2701025,مب بازار مکتب,Mir Bazar School,0,34,499,3476,4009
27,270107,2701026,قون منځن ښونځ,Qubi Secondary School,0,106,192,4720,5018
27,270107,2701027,د مبويس مين اناث مكتب,Mirwais Menah Girls School,0,73,2871,5683,8627
27,270108,2701028,غازی امان الله خان عالی لیسه,Ghazi Amanullah Khan High School,0,338,565,6358,7261
27,270108,2701029,د فاضل كندهاري مكتب,Fazil Kandahari School,0,123,558,5085,5766
27,270109,2701032,د محمود طرزي ليسه,Mahmoud Tarzi High School,0,47,1108,5318,6473
27,270109,2701033,شهيد عظيم الله ښوونځ,Shaheed Azimullah School,0,69,1687,9737,11493
27,270109,2701034,کوتل مورچه مکتب,Kotal Morcha School,0,84,796,9930,10810
27,270110,2701035,د سيدآباد ښوونځ,Sayed Abad School,0,157,1625,7680,9462
27,270110,2701036,مسجد سید شهدا حضت حمزه,Sayed Shuhada Hazrat Hamza Mosque,0,95,240,4372,4707
27,270110,2701037,شهيد عبدالاحد خان كرزي لیسه,Shaheed Abdul Ahad Khan Karzai High School,0,93,1919,5490,7502
27,270110,2701038,ریاست کادسب,Cadaster Directorate,0,73,275,3836,4184
27,270110,2701039,د سيد جمال الدين لیسه,Sayed Jamaluddin High School,0,56,3112,9398,12566
27,270110,2701040,ظریف مېنه منځن ښوونځ,Zareef Menah Secondary School,0,1409,714,5727,7850
27,270113,2701030,افغان تیموری ابتدایه ښونځ,Afghan Temoori Primary School,0,5,299,2282,2586
27,270113,2701031,مبزا احمدخان مکتب,Mirza Ahmad Khan School,0,50,272,3052,3374
27,270101,2701001,ظاهر شاهی مكتب,Zahir Shahi School,0,77,2311,6521,8909
27,270101,2701002,د عینو لیسه,Aino High School,0,62,1287,5451,6800
27,270101,2701003,طبعی پیشو په وړاند د مباریزی ریاست,Natural Disasters Management Directorate,0,35,1211,4109,5355
27,270101,2701004,د عينو منځن ښوونځ,Aino Secondary School,0,16,2314,6085,8415
27,270101,2701005,حنفیه مدرسه,Hanafiah Madrassah,0,87,1026,3697,4810
27,270101,2701006,محمديه مدرسه,Mohammadiah Madrassah,0,16,636,3071,3723
27,270101,2701007,د صوف صاحب ذکور مكتب,Soufi Sahib Boys School,0,27,2175,3462,5664
27,270101,2701008,د صوف صاحب اناث مكتب,Soufi Sahib Girls School,0,2,2012,2920,4934
27,270101,2701009,د اقتصاد ریاست,Directorate of Economy,0,36,484,3339,3859
27,270102,2701010,احمدشاه بابا ليسه,Ahmad Shah BaBa High School,0,16,512,4627,5155
27,270102,2701011,زرغونه انا ليسه,Zarghoona Ana High School,0,89,2050,5444,7583
27,270102,2701012,زینب لیسه,Zainab High School,0,9,1355,5711,7075
27,270102,2701013,مشف ليسه,Mashreqi High School,0,56,2751,9593,12400
27,270102,2701014,مسجد سالو خان چمن,Salo Khan Chaman Mosque,0,346,340,4499,5185
27,270102,2701015,مكتب حاج عرب,Haji Arab School,0,740,1233,8722,10695
27,2702,2702041,باغ پل هوټل پارک,Bagh Pul Hotel Park,0,35,123,1062,1220
27,2702,2702042,خوشحال خان مكتب,Khoshal Khan School,0,64,136,2370,2570
27,2702,2702043,مكتب كوهك,Kohak School,0,24,35,1735,1794
27,2702,2702044,مكتب مناره,Menarah School,0,14,11,1556,1581
27,2702,2702045,د شاه اشف مكتب,Shah Ashraf School,0,0,21,1101,1122
27,2702,2702046,بابا ولی تعمب,Ba Ba Wali Building,0,12,26,841,879
27,2702,2702047,د بابا صاحب دوراهی د ابیاری ریاست,"Ba Ba Sahib Du Rahi, Directorate of Irrigation",0,35,79,1408,1522
27,2702,2702048,سلطان محمود غزنوي مكتب,Sultan Mahmoud Ghaznavi School,0,71,64,2169,2304
27,2702,2702049,د جلا اور مكتب,Jala Awr School,0,100,26,1390,1516
27,2702,2702050,بسم الله خان مسجد,Bismillah Khan Mosque,0,10,56,1795,1861
27,2702,2702051,د مولوی عبدالواسع مكتب,Mawlawi Abdul Wase School,0,42,164,1780,1986
27,2702,2702052,شي اولیا شهید فیض محمد مسجد,Sheen Awlya Shaheed Faiz Mohammad Mosque,0,1,27,1490,1518
27,2702,2702053,مكتب محمد یعقوب قلعچه,Mohammad Yaqoub Qalacha School,0,18,35,684,737
27,2702,2702054,مكتب خواجه ملك,Khwajah Malik School,0,17,65,942,1024
27,2702,2702055,مدرسه خانه ګرداب,Khanah Gardab Madrassah,0,7,50,1784,1841
27,2702,2702056,منصوراباد قادری مکتب,Mansour Abad Qaderi School,0,10,95,990,1095
28,2801,2801001,لیسه نسوان کوک گنبد,Kog Gunbad Girls High School,0,1,528,757,1286
28,2801,2801002,لیسه عرب خانه,Arab Khana High School,0,4,1346,1005,2355
28,2801,2801003,لیسه جبال عبدالرشید دوستم,Gen. Abdul Rasheed Dustam High School,0,0,2033,1326,3359
28,2801,2801004,لیسه ابن یمی,Ibne Yameen High School,0,3,514,2134,2651
28,2801,2801005,لیسه مبویس مینه,Mirwais Menah High School,0,2,1291,803,2096
28,2801,2801006,لیسه مولانا اذنب,Mawlana Aznab High School,0,0,1185,1501,2686
28,2801,2801007,لیسه عید محله,Eid Mohalla High School,0,2,2553,1928,4483
28,2801,2801008,لیسه غلام سرور شهید,Ghulam Sarwar Shaheed High School,0,4,1690,1159,2853
28,2801,2801009,لیسه فرزام شهید,Farzam Shaheed High School,0,0,1182,901,2083
28,2801,2801010,لیسه خدیجه,Khadija High School,0,0,949,745,1694
28,2801,2801011,لیسه چرمگر خانه,Charamgar Khana High School,0,11,2088,1805,3904
28,2801,2801012,لیسه ذکور منگوت,Mangotai Boys High School,0,0,152,154,306
28,2801,2801013,مکتب متوسطه چغچ,Cheghchi Secondary School,0,0,166,363,529
28,2801,2801014,لیسه قزانچ بابا,Qazanchi Ba Ba High School,0,1,1517,1166,2684
28,2801,2801015,مکتب متوسطه چوباش کلان,Chobash Kalan Secondary School,0,0,250,380,630
28,2801,2801016,ریاست زراعت,Agriculture Directorate,0,179,494,986,1659
28,2801,2801017,لیسه ذکور یکه باغ,Yaka Bagh Boys High School,0,1,1093,879,1973
28,2801,2801018,لیسه بابا علی,Ba Ba Ali High School,0,0,1960,1119,3079
28,2801,2801019,مکتب متوسطه شکرک,Shakarak Secondary School,0,32,174,331,537
28,2801,2801020,لیسه حسن تابی,Hasan Tabeen High School,0,0,614,568,1182
28,2801,2801021,لیسه تونکه,Tonkah High School,0,2,611,492,1105
28,2801,2801022,مکتب متوسطه قوچی,Qoukcheen Secondary School,0,0,336,582,918
28,2801,2801023,لیسه ذکور قره کینت,Qara Kent High School,0,0,521,435,956
28,2801,2801024,لیسه افغان تپه,Afghan Tepah High School,0,1,856,861,1718
28,2801,2801025,مسجد منگوت افغانیه,Mangotai Afghania High School,0,0,260,288,548
28,2801,2801026,لیسه آلت خواجه,Alti Khwajah High School,0,1,1129,873,2003
28,2801,2801027,لیسه صوف قلعه,Soufi Qalla High School,0,1,370,274,645
28,2801,2801028,مکتب متوسطه چهار شنبه,Chahar Shanbah Secondary School,0,0,916,449,1365
28,2801,2801029,مکتب متوسطه جلال آباد,Jalalabad Secondary School,0,2,1298,987,2287
28,2801,2801030,لیسه مصرآباد,Mesar Abad High School,0,0,1429,815,2244
28,2801,2801031,لیسه ینگ اری غ,Yangi Areegh High School,0,0,1210,877,2087
28,2802,2802032,مکتب متوسطه طاغن,Taghun Secondary School,0,36,794,913,1743
28,2802,2802033,لیسه چوب باش,Chob Bash High School,0,4,2130,1547,3681
28,2802,2802034,مبل حاج صالح,Haji Saleh House,0,0,256,304,560
28,2802,2802035,لیسه ذکور خواجه دوکوه,Khwajah Du Koh Boys High School,0,0,2847,1779,4626
28,2802,2802037,لیسه قزل ایاق,Qazal Ayaq High School,0,0,916,643,1559
28,2803,2803039,مکتب متوسطه الیک رباط,Aleek Rubat Secondary School,0,0,390,275,665
28,2803,2803044,لیسه ذکور علیلی,Alilil Boys High School,0,2,1097,812,1911
28,2804,2804050,لیسه چارچنغو,Charchanghu High School,0,0,118,406,524
28,2804,2804051,مکتب منگجیک,Mangeejak School,0,0,36,254,290
28,2805,2805062,مکتب ترکمن قدوق,Turkman Qaduq School,0,7,462,473,942
28,2805,2805065,مکتب جرقدوق,Jarqadooq School,0,1,437,559,997
28,2805,2805066,مکتب متوسطه نو آباد,Nawabad Secondary School,0,0,329,226,555
28,2806,2806070,مکتب سید اسماعیل,Sayed Ismael School,0,0,11,36,47
28,2806,2806071,مکتب خم آب,Khum Aab School,0,0,14,55,69
28,2807,2807072,مکتب ذکور نمب دوم,Boys School NO. 2,0,1,528,537,1066
28,2807,2807073,لیسه ذکور آقچه,Aqcha Boys High School,0,1,1035,1475,2511
28,2807,2807074,لیسه نسوان آقچه,Aqcha Girls High School,0,2,1022,1017,2041
28,2807,2807075,لیسه ذکور نمب اول,Boys High School no. 1,0,2,892,948,1842
28,2807,2807076,مکتب نسوان بت کوت اوزبیکیه,Bati Kot Uzbekyah Girls School,0,0,276,246,522
28,2807,2807077,مسجد ابوبکر صدیق,Abu Baker Sediq Mosque,0,0,1280,2576,3856
28,2807,2807085,مکتب قره بویی,Qara Boyeen School,0,0,10,82,92
28,2808,2808090,مکتب کوکلداش,Kokaldash School,0,0,278,660,938
28,2808,2808093,لیسه چارباغ,Char Bagh High School,0,0,0,1,1
28,2808,2808094,لیسه نسوان شهید لطیفه حبیت,Shaheed Latifa Habibi Girls High School,0,1,1072,1050,2123
28,2808,2808095,لیسه ذکور شیشه خانه,Shesha Khan Boys High School,0,0,275,518,793
28,2808,2808096,مکتب متوسطه ذکور گرجک,Gerjak Boys Secondary School,0,0,183,192,375
28,2808,2808097,مکتب متوسطه ذکور حیدر آباد,Haider Abad Boys Secondary School,0,0,268,337,605
28,2810,2810112,مکتب متوسطه جوی سرای,Joi Sarai Secondary School,0,0,194,319,513
28,2810,2810113,لیسه مخدوم قلی فراغ,Makhdoom Quli Faraghi High School,0,1,514,1287,1802
29,2901,2901001,لیسه نسوان کوهی خانه میمنه,Kohi Khana Maimana Girls High School,0,0,1297,1291,2588
29,2901,2901002,مکتب ظاهر آباد,Zahir Abad School,0,0,408,483,891
29,2901,2901003,مکتب لیسه نسوان مولانا امرالله,Maulana Amrullah Girls High School,0,2,1247,1282,2531
29,2901,2901004,لیسه ابوعبید جوزجای,Abu Obaid Jawzjani High School,0,1,749,2070,2820
29,2901,2901005,لیسه نسوان افغانکوت,Afghan Kot Girls High School,0,1,1598,834,2433
29,2901,2901006,مدرسه عالی ابو مسلم خراسای,Abu Muslim Khurasani Madrasa,0,1,749,904,1654
29,2901,2901007,مکتب متوسطه جرنیل غوث الدین,General Ghawsoddin Secondary School,0,0,567,1435,2002
29,2901,2901008,لیسه گوهر شاد بیگم,Gohar Shad Begam High School,0,4,806,1032,1842
29,2901,2901009,لیسه ستاره,Setara High School,0,1,1384,1048,2433
29,2901,2901010,لیسه خراسان,Khurasan High School,0,0,992,1367,2359
29,2901,2901011,مدیریت وتر نری,Veternary Department,0,0,828,1099,1927
29,2901,2901012,مکتب ذکور همت آباد,Hemat Abad Boys School,0,0,850,640,1490
29,2901,2901013,لیسه نسوان ده سیدان,Deh Saydan Girls High School,0,0,719,452,1171
29,2901,2901014,مکتب متوسطه دولت کپتان,Dawlat Kaptan Secondary School,0,0,737,635,1372
29,2901,2901015,مکتب لیسه صیاد رجب,Sayad Rajab High School,0,0,221,196,417
29,2901,2901016,مکتب نسوان پشه خای,Pasha Khani Girls School,0,0,591,339,930
29,2901,2901017,مکتب متوسطه یمبلاق,Yambalaq Secondary School,0,0,437,614,1051
29,2901,2901018,لیسه ذکور تورپاختو,Torpakhto Boys High School,0,0,767,556,1323
29,2901,2901019,لیسه مسلکی زراعت میمنه,Agriculture Vocational High School of Maimana,0,1,140,538,679
29,2901,2901020,ریاست دارالمعلمی عالی فاریاب,Directorate of Faryab Teachers Training College,0,0,540,552,1092
29,2901,2901021,مکتب ذکور چعاتک,Chaa'tak Boys School,0,21,250,925,1196
29,2901,2901022,مکتب سربلاق,Sarbalaq School,0,1,555,591,1147
29,2901,2901023,مکتب ذکور خوجه پایتخت,Khoja Paitakht Boys School,0,0,548,440,988
29,2901,2901024,لیسه ده عزیزان,Deh Azizan High School,0,0,517,355,872
29,2902,2902028,مسجد قلعه سر حوض,Qala Sar Hawz Mosque,0,1,589,2367,2957
29,2902,2902040,مکتب متوسطه ذکور مرحوم الحاج روزی,Alhaj Roziqul Karwan Bashi Boys Secondary School,0,0,481,9ل ک7ا4روان با,960
29,2902,2902041,لیسه انجلاد,Anjalad High School,0,1,1393,858,2252
29,2902,2902042,مکتب متوسطه جمشیدی,Jamshidi Secondary School,0,0,819,726,1545
29,2902,2902043,مسجد علیکه بالا,Alika Bala Mosque,0,0,401,299,700
29,2902,2902044,مکتب لیسه قزلقول,Qazal Qol High School,0,0,278,431,709
29,2902,2902045,مکتب دهندره,Dahandara School,0,1,2199,2302,4502
29,2902,2902056,مکتب متوسطه ذکور عرب آقسای,Arab Aaqsai Boys Secondary School,0,1,1147,1731,2879
29,2903,2903071,تعمی لیسه ذکور ده نو,Deh Naw Boys High School Building,0,0,275,375,650
29,2903,2903072,لیسه نسوان بادغیسی,Badghisy Girls High School,0,1,455,569,1025
29,2904,2904085,مسجد جامع چغاتک,Chaghatak Jami Mosque,0,0,278,456,734
29,2904,2904086,مکتب لیسه نسوان شهید علاءالدین,Shaheed Alauddin Girls High School,0,0,999,1372,2371
29,2904,2904087,لیسه ذکور المار,Almar Boys High School,0,4,430,596,1030
29,2904,2904088,مسجد جامع جلگلدی,Jalgaldy Jami Mosque,0,3,1652,1741,3396
29,2904,2904089,مسجد جامع حاج سعید احمد,Haji Saeed Ahmad Jami Mosque,0,1,1023,1959,2983
29,2905,2905096,مکتب ذکورتغلمس,Taghlams Boys School,0,2,1680,2272,3954
29,2905,2905104,مکتب متوسطه ذکور چرمگری,Charamgari Boys Secondary School,0,2,1728,2330,4060
29,2905,2905105,مدرسه مرکز بلچراغ,Markaz Balcharagh Madrasa,0,0,1218,1608,2826
29,2905,2905106,مکتب متوسطه مختلط کینقول,Kenqol Boys and Girls Secondary School,0,1,1824,1742,3567
29,2906,2906113,لیسه شمس الدین شهید,Shamsuddin Shaheed High School,0,0,1065,607,1672
29,2906,2906115,مسجد قاض قشلاق,Qazi Qeshlaq Mosque,0,0,464,235,699
29,2906,2906116,لیسه نسوان کوه صیاد,Koh Sayaad Girls High School,0,0,630,621,1251
29,2907,2907123,مکتب چکنه یوزبیگ,Chakna Yozbegi School,0,0,784,574,1358
29,2907,2907124,مسجد جامع خواجه های بورغن,Khwajaha-e-Borghan Jami Mosque,0,2,322,708,1032
29,2907,2907125,مسجد جامع صیاد بورغن,Sayad Borghan Jami Mosque,0,8,503,512,1023
29,2907,2907128,مکتب خواجه تبجاق,Khwaja Tabjaq School,0,0,1179,1921,3100
29,2907,2907129,مسجد جامع ثور,Sawr Jami Mosque,0,0,363,553,916
29,2907,2907130,مکتب کوهی,Kohi School,0,0,520,704,1224
29,2907,2907131,مسجد جامع ینگ زرغوی,Yangee Zarghoi Jami Mosque,0,2,475,628,1105
29,2907,2907132,مکتب متوسط نسوان مهدی خواجه,Mahdi Khwaja Girls Secondary School,0,2,317,681,1000
29,2907,2907133,لیسه نادم قیصاری,Naadim Qaisary High School,0,1,585,889,1475
29,2907,2907134,مکتب متوسطه ذکور بوری,Bori Boys Secondary School,0,2,1161,563,1726
29,2907,2907135,مکتب ابتدایه یلدوز,Yaldoz Primary School,0,0,303,351,654
29,2907,2907136,مسجد امام ابو حنیفه,Imam Abu Hanifa Mosque,0,2,1249,2048,3299
29,2907,2907137,مکتب ذکور صوف قلعه,Sofi Qala Boys School,0,1,1516,1483,3000
29,2907,2907138,مسجد یکه پسته افغانیه,Yaka Pista Afghania Mosque,0,4,1429,1737,3170
29,2907,2907139,مسجد جامع بیکه,Berka Jami Mosque,0,23,934,1135,2092
29,2907,2907141,مکت ابتدائیه زوری ها,Zoriha Primary School,0,3,1869,2376,4248
29,2907,2907143,مکتب ابتدای چیچکتو,Chechakto Primary School,0,0,341,1881,2222
29,2907,2907150,مسجد چهار شنبه ازبکیه,Charshamba Uzbakia Mosque,0,0,1763,2102,3865
29,2907,2907151,مکتب ابتدائیه ذکور هزاره قلعه چهلگزی,Hazara Qala Chalgazi Boys Primary School,0,0,591,2154,2745
29,2908,2908168,لیسه ذکور سرچکان,Sarchakan Boys High School,0,0,719,2187,2906
29,2908,2908169,لیسه نسوان دونگ قلعه,Dong Qala Girls High School,0,1,2256,5744,8001
29,2909,2909180,مسجد جامع قریه چغتای,Chaghtay Village Jami Mosque,0,0,534,1634,2168
29,2909,2909181,لیسه عبدالرحمن شهید,Abdul Rahman Shaheed High School,0,3,655,812,1470
29,2909,2909182,لیسه نسوان مرکزی,Central Girls High School,0,1,907,750,1658
29,2911,2911202,مکتب نسوان یوسف میزای,Yosof Mirzayee Girls School,0,1,881,678,1560
29,2911,2911203,لیسه مختلط آلت بولک,Aalti Bolak Boys and Girls High School,0,2,827,817,1646
29,2911,2911204,مکتب متوسطه قپچاق,Qechaq Secondary School,0,0,370,291,661
29,2911,2911205,لیسه نسوان آلت بولک,Aalti Bolak Girls High School,0,0,364,0,364
29,2911,2911206,مکتب ابتدائیه آلت بولک بالا,Aalti Bolak Bala Primary School,0,0,601,381,982
29,2911,2911207,تعمی ولسوالی قرمقول,Qaramqol District Building,0,0,260,449,709
29,2911,2911208,مکتب ابتدائیه یکه توت,Yaka Toot Primary School,0,0,689,448,1137
29,2911,2911209,مکتب متوسطه سربند,Sarban Secondary School,0,0,172,111,283
29,2912,2912211,لیسه مسلکی زراعت کارگر,Kargar Agriculture Vocational High School,0,0,653,787,1440
29,2912,2912212,لیسه یوسف اند خوی,Yusof Andkhoi High School,0,0,740,955,1695
29,2912,2912213,لیسه مختلط ملا کریم نظر,Mullah Karim Naza Boys and Girls High School,0,0,375,309,684
29,2912,2912214,مکتب ابتداییه سرخ بازار,Sorkh Bazar Primary School,0,0,220,722,942
29,2912,2912215,آق مسجد,Aaq Masjid,0,0,483,644,1127
29,2912,2912216,لیسه باغ بوستان,Bagh e Bostan High School,0,0,860,1129,1989
29,2912,2912217,لیسه ذکور می سید برکه,Mir Sayed Barka Boys High School,0,0,393,443,836
29,2912,2912218,لیسه ذکورمی آباد,Mir Abad Boys High School,0,1,655,0,656
29,2912,2912219,مکتب ابتداییه ذکور میاباد,Mir Abad Boys Primary School,0,1,306,666,973
29,2912,2912220,مکتب متوسطه کهنه قرغان,Kohna Qorghan Secondary School,0,0,251,162,413
29,2912,2912221,مکتب متوسطه یکه توت,Yaka Toot Secondary School,0,0,278,296,574
29,2913,2913222,لیسه دولت گیلدی,Dawlat Gildi High School,0,3,2004,2527,4534
29,2913,2913223,مکتب نسوان الهندی خانه,Alhindi Khana Girls School,0,0,998,882,1880
29,2913,2913224,لیسه نسوان کلال خانه,Kulal Khana Girls High School,0,1,1302,1236,2539
29,2913,2913225,لیسه قاض بابه مراد,Qazi Baba Murad High School,0,0,368,661,1029
29,2913,2913226,لیسه ابو مسلم,Abu Muslim High School,0,0,754,1517,2271
29,2913,2913227,لیسه نسوان یولدوز,Yoldoz Girls High School,0,1,1587,1306,2894
29,2913,2913228,مکتب متوسطهء نسوان غجرآبادn\,Ghajar Abad Girls Secondary School,0,20,1186,1027,2233
29,2913,2913229,لیسه نسوان تواج,Tawache Girls High School,0,0,1213,947,2160
29,2913,2913230,لیسه نسوان ینگ تیگرمان,Yangee Tigerman Girls High School,0,0,1039,759,1798
29,2913,2913231,مکتب متوسطه رحمت الله شهید,Rahmatullah Shaheed Secondary School,0,0,543,664,1207
29,2914,2914232,مکتب ابتدائیه مختلط اوچ تپه,Awch Tapa Boys and Girls Primary School,0,0,584,272,856
29,2914,2914233,لیسه چکمن,Chakman High School,0,1,446,609,1056
29,2914,2914234,لیسه ذکور خان چهارباغ,Khan-i-Charbagh Boys High School,0,0,997,1389,2386
29,2914,2914235,مسجد بندر آقینه,Bandar (Port) Aaqina Mosque,0,0,0,106,106
29,2914,2914236,لیسه نسوان عرب شاه پایی,Arab Shah Payeen Girls High School,0,0,1692,694,2386
29,2914,2914237,مکتب ابتدائیهء مختلط قلعهء نیستان,Qala Nestan Boys and Girls Primary School,0,1,499,676,1176
29,2914,2914238,مکتب ابتدائیه مختلط عرب شاه بالا,Arab Shah Bala Boys and Girls Primary School,0,0,584,413,997
30,3001,3001001,د سید نب کور,Sayed Nabi House,0,36,318,2200,2554
30,3001,3001002,مسجد معلم عبدالله,Malem Abdullah Mosque,1,93,448,2519,3061
30,3001,3001003,د حاج کریم داد کلی مکتب,Haji Karimdad Village School,0,55,263,3122,3440
30,3001,3001004,دکاریز لیسه,Kariz High School,0,86,962,3628,4676
30,3001,3001005,دارالعلوم نقشبندیه,Darul Uloom Naqshbandia,0,13,211,3107,3331
30,3001,3001006,دکلا کهنه دهلکانو مکتب,Kala Kohna Boys School,0,107,1398,8573,10078
30,3001,3001007,د شهید حاج شیمحمد مسجد,Shaheed Haji Sher Mohammad Mosque,0,77,943,4552,5572
30,3001,3001008,دنوی صافیانو عال لیسه,New Safi High School,0,63,647,3844,4554
30,3001,3001009,لیسه کارته لگن,Karta Lagan High School,0,89,1247,7247,8583
30,3001,3001010,د هندوانو مکتب,Hindu School,0,16,977,4080,5073
30,3001,3001011,لیسه ملال,Malalai High School,0,7,2166,3653,5826
30,3001,3001012,نمرات C1 مکتب,C1 Residential Plots School,0,70,589,5857,6516
30,3001,3001013,لیسه c3,C3 High School,0,57,1483,3238,4778
30,3001,3001014,لیسه B2-1,B2-1 High School,0,27,1286,2280,3593
30,3001,3001015,د تور تانک د هلکانو مکتب,Tor Tank Boys School,0,18,2575,6856,9449
30,3001,3001016,د نجونو ليسه,Girls High School,0,97,3438,7609,11144
30,3001,3001017,د هلكانو ليسه,Boys High School,1,92,174,9354,9621
30,3001,3001018,سینمای لشکرگاه,Lashkargah Cinema,1,126,607,8256,8990
30,3001,3001019,اهل هنود مکتب,Hindu School,0,41,1218,6180,7439
30,3001,3001020,د فارم تعمی بولان,Farm Building-Bolan,0,35,676,8348,9059
30,3001,3001021,مکتب بولان کلا,Bolan Kala School,1,69,287,5642,5999
30,3001,3001022,متوسطه مختار,Mokhtar Secondary School,0,15,278,1664,1957
30,3001,3001023,مکتب متوسطه کمپ مختار,Camp Mokhtar Secondary School,0,441,252,3643,4336
30,3001,3001024,لیسه کمپ مختار,Camp Mokhtar High School,0,70,682,5376,6128
30,3001,3001025,مکتب c2,C2 School,0,6,337,2831,3174
30,3001,3001026,ابتدائیه کارته مامورین,Karta Mamorin Primary School,0,21,54,2572,2647
30,3001,3001027,مکتب ابتدائیه لشکربازار شق,Lashkar Bazar Sharqi Primary School,0,23,136,3164,3323
30,3001,3001028,حاج طاوس مسجد,Haji Tawos Mosque,0,162,461,7166,7789
30,3002,3002036,دوراهی,Do Rahi,0,9,73,3527,3609
30,3002,3002037,مکتب شی کلی,Shen Kalai School,0,27,936,2779,3742
30,3002,3002038,مکتب سید آباد,Sayed Abad School,0,2,592,3508,4102
30,3002,3002039,کلینیک ولسوال ناد علی,Naad Ali District Clinic,0,7,224,2067,2298
30,3002,3002040,مکتب مرکز ولسوال,District Center School,0,1,18,2929,2948
30,3002,3002041,مکتب لوی باغ,Loy Bagh School,0,16,317,1677,2010
30,3002,3002042,مکتب زرغون کلی,Zarghon Kalai School,0,61,536,5228,5825
30,3002,3002046,مکتب ناقل آباد,Naqil Abad School,0,5,590,2947,3542
30,3002,3002047,مسجد چاه میزا,Chah Mirza Mosque,0,14,563,5293,5870
30,3002,3002048,نور محمد كلی مكتب,Noor Mohammad Village School,0,18,554,5239,5811
30,3003,3003050,اسدالله مسجد,Asadullah Mosque,0,1,381,2740,3122
30,3003,3003051,مكتب هزار اسپ,Hazar Asp School,0,26,272,2834,3132
30,3003,3003052,د نیک محمد مسجد,Nek Mohammad Mosque,0,18,0,1477,1495
30,3003,3003054,د باسلانو روغتیای مرکز,Basalan Health Facility,0,2,0,1362,1364
30,3003,3003056,مكتب ګورګی علیا,Gorgin Olia School,0,9,20,1552,1581
30,3003,3003057,د عبدالحكيم مسجد,Abdul Hakim Mosque,0,0,39,1415,1454
30,3003,3003058,د نب خان مسجد,Nabi Khan Mosque,0,1,16,1325,1342
30,3003,3003060,كلينيك بلاک ـ ۱,Clinic Block-1,0,48,8,2283,2339
30,3003,3003061,لیسه خلج,Khalj High School,0,0,49,2171,2220
30,3003,3003062,كلينيك خرابه,Kharaba Clinic,0,2,12,1648,1662
30,3003,3003064,مكتب خسرآباد,Khosrabad School,0,3,6,1561,1570
30,3003,3003065,مكتب ګورګی صفلا,Gorgin Sofla School,0,5,251,2612,2868
30,3003,3003066,د لوی کلی مكتب,Loy Kali School,0,36,611,2505,3152
30,3003,3003068,مكتب دوپله,Doila School,0,17,41,1719,1777
30,3003,3003069,د کرزی مکتب,Karzai School,0,83,313,3175,3571
30,3003,3003070,حاج شدار اکا مسجد,Haji Sardar Aka Mosque,0,109,812,2219,3140
30,3004,3004077,مسجد عبدالرشید,Abdul Rashid Mosque,0,1,0,622,623
30,3004,3004086,د کندهار هده مسجد,Kandahar Bus Station Mosque,0,12,173,1178,1363
30,3004,3004088,شفاخانه گرشک,Garishk Hospital,0,39,247,4439,4725
30,3004,3004089,ليسه ابوالفتح بسب,Abul Fath Basti High School,0,78,1201,4551,5830
30,3004,3004090,د نجونو لیسه,Girls High School,0,27,1703,5613,7343
30,3004,3004091,مسجد روف خان شيله,Rawof Khan Shela Mosque,0,60,703,5008,5771
30,3004,3004092,دگرشک د حاج فابریکه,Garishk Haji Factory,0,6,446,5622,6074
30,3004,3004093,میزاخان جامع,Mirzakhan Jami Mosque,0,59,957,4413,5429
30,3005,3005099,د شوراب مکتب,Shorab School,0,37,0,2227,2264
30,3005,3005100,مکتب شمرزی,Shamarzai School,0,36,3,1595,1634
30,3006,3006109,حاج شاه خان مسجد,Haji Shah Khan Mosque,0,7,9,1312,1328
30,3006,3006110,د ولسوال مركزی مكتب,District Central School,0,6,31,689,726
30,3006,3006112,مكتب هزار جفت,Hazar Joft School,0,25,148,3205,3378
30,3006,3006113,شملان حاج محمد یار اکا مسجد,Shamlan Haji Mohammad Yar Aka Mosque,0,7,0,2853,2860
30,3008,3008140,مركزي شفاخانه,Central Hospital,0,0,0,926,926
30,3010,3010163,مکتب کجك سفلی,Kajaki Sofla School,0,0,0,194,194
30,3010,3010164,مسجد,Mosque,0,0,0,173,173
30,3014,3014217,د می همزه كور,Trikh Nawor School,0,53,439,8963,9455
30,3015,3015226,منی گردی,Minbar Gardani,0,0,286,334,620
30,3015,3015227,مسجد مغول آباد,Moghol Abad Mosque,0,0,129,81,210
30,3015,3015228,لیسه مرکزی ناوه میش,Nawa Mesh Central High School,0,0,286,163,449
30,3015,3015229,مسجد جامع بازار ناوه میش,Nawa Mesh Bazaar Jami Mosque,0,0,352,643,995
30,3015,3015230,منی شخ جوی,Sorkh Joy,0,1,158,157,316
30,3015,3015231,مسجد جامع صادقیه گنبد,Sadiqia Gumbad Jami Mosque,0,0,268,140,408
30,3015,3015232,حسینیه هفتک,Hafak Husainia,0,0,184,129,313
30,3015,3015233,مسجد شور خان,Sarwar Khan Mosque,0,0,259,167,426
30,3015,3015234,منی دهن اورخان,Minbar Dahan Orkhan,0,0,172,174,346
30,3015,3015235,مسجد امام صادق,Imam Sadiq Mosque,0,0,335,334,669
30,3015,3015236,مسجد شپل,Sari Pul Mosque,0,0,189,162,351
30,3015,3015237,منی سید آباد,Minbar Sayed Abad,0,0,57,137,194
30,3015,3015238,منی جوزاری,Minbar Jozari,0,0,135,64,199
30,3015,3015239,مسجد جامع حضت علی,Hazrat Ali Jami Mosque,0,0,258,218,476
30,3015,3015240,منی شنیه,Minbar Shania,0,0,154,75,229
30,3015,3015241,میدان فوتبال گردی,Gardi Football Ground,0,0,95,78,173
30,3015,3015242,حسینیه شای,Shani Husainia,0,0,202,134,336
30,3015,3015243,منیشلغم,Minbar Shalgham,0,0,0,24,24
30,3015,3015244,منی انجی باش,Minbar Anjeer Bash,0,0,123,75,198
30,3015,3015245,حسینیه حضت ابوالفضل,Hazrat Abul Fazal Husainia,0,0,207,166,373
30,3015,3015246,مکتب متوسطه غیچ,Gheech Secondary School,0,0,289,201,490
30,3015,3015247,منی قول آلو,Menbar e Qul Aalo,0,0,134,117,251
31,3101,3101001,لیسه نسوان شهر قلعه نو,Shahr Qalla Naw Girls High School,0,1,4254,0,4255
31,3101,3101002,قلعه نو مکتب حنظله,Qalla Nawm Hanzalah School,0,18,0,7111,7129
31,3101,3101003,مکتب قر قیطو,Qarqeetu School,0,0,773,738,1511
31,3101,3101004,مکتب زرد شمال دریا شهر قلعه نو,"Zard Shamal School, Shahr e Qalla Naw Darya",0,0,1999,2357,4356
31,3101,3101005,مکتب فرستان,Farestan School,0,1,831,825,1657
31,3101,3101006,مکتب خم عباسی,Kham Abasi School,0,0,154,269,423
31,3101,3101007,مکتب چشمه دوزدک,Chashmah Dozdak School,0,1,542,456,999
31,3101,3101008,مکتب تگاب اسماعیل,Tagab Ismael School,0,2,873,904,1779
31,3101,3101009,مکتب باغبان سنگ پنجه,Baghban Sang Panjah School,0,11,330,322,663
31,3101,3101010,خانه اجتماعی,Khana Ijtemai (Social Hall),0,2,324,392,718
31,3101,3101011,مکتب ندامی,Nadami School,0,0,40,260,300
31,3101,3101012,مسجد برات,Barati Mosque,0,0,189,81,270
31,3101,3101013,مکتب متوسطه خان آقا,Khan Aqa Secondary School,0,0,295,339,634
31,3101,3101014,کلینیک چکاب,Chakab Clinic,0,0,474,555,1029
31,3101,3101015,مکتب لیسه لامان,Laman High School,0,0,155,577,732
31,3101,3101020,مکتب خارستان,Kharestan School,0,0,228,291,519
31,3101,3101021,مکتب چهار باغ,Chahar Bagh School,0,0,554,409,963
31,3101,3101022,مکتب باغک,Baghak School,0,0,1079,723,1802
31,3101,3101023,مکتب قریه کندلان,Kundalan village School,0,0,533,488,1021
31,3101,3101211,مکتب چاکران,Chakaran School,0,2,486,708,1196
31,3102,3102024,مسجدجامع تگاب رباط بالا,Tagab Rubat Bala Jame Mosque,0,0,77,166,243
31,3102,3102025,مسجد جامع سینه اردو,Senah Urdu Jame Mosque,0,0,120,203,323
31,3102,3102026,مسجد سنگ لوح,Sang Lawh Mosque,0,0,37,109,146
31,3102,3102027,لیسه دهستان,Dehestan High School,0,15,368,384,767
31,3102,3102028,مکتب گدرها,Gadar ha School,0,0,38,197,235
31,3102,3102029,مکتب چالانک,Chalanak School,0,0,375,347,722
31,3102,3102030,مکتب متوسطه ملاکریم,Mulla Karim Primary School,0,1,346,289,636
31,3102,3102031,مکتب قریه سی زارک,Serzarak village School,0,0,385,364,749
31,3102,3102032,مکتب نسوان گلخانه,Gulkhanah Girls School,0,0,455,412,867
31,3102,3102033,مکتب متوسطه گنداب,Gandab Secondary School,0,2,447,484,933
31,3102,3102034,مکتب سفیدلک,Safidlak School,0,0,19,62,81
31,3102,3102035,لیسه تا شبولاق,Tashbulaq High School,0,0,159,177,336
31,3102,3102041,مکتب لیسه کوچه زرد,Kocha e Zard High School,0,0,427,561,988
31,3102,3102042,مکتب متوسطه زادمراد,Zadmurad Secondary School,0,4,0,508,512
31,3102,3102043,کلینیک ولسوالی آبکمریx000D_\n_,Aab Kamari District Clinic,0,1,2248,3135,5384
31,3102,3102054,مکتب متوسطه سنگ آتش,Sang Atash Secondary School,0,0,336,808,1144
31,3102,3102055,لیسه جعفری,Jafari High School,0,0,465,410,875
31,3103,3103061,مکتب لیسه زاد علی,Zad Ali High School,0,0,0,20,20
31,3103,3103062,مسجد فیوزی,Ferozi Mosque,0,137,44,612,793
31,3103,3103063,مکتب ابتدات مزید ها,Mazeed ha Primary School,0,51,273,569,893
31,3103,3103064,مکتب ابتدائیه قریه جکنه,Jaknah village Primary School,0,5,200,522,727
31,3103,3103065,مکتب تاجک ها,Tajik ha School,0,1,195,376,572
31,3103,3103068,مکتب حاج میاحمد خان پلوچ,Haji Mir Ahmad Khan Balouch School,0,154,162,391,707
31,3103,3103069,مکتب قریه سنجیتک,Sanjeetak village School,0,1,574,425,1000
31,3104,3104089,مکتب باب دوست,Bab Dusti School,0,0,24,138,162
31,3104,3104090,کلینیک قرچیغ,Qarcheeghi clinic,0,2,362,249,613
31,3104,3104091,مکتب ملایان,Mulayan School,0,0,70,231,301
31,3104,3104099,لیسه جمیعت,Jamiat High School,0,1,1017,1399,2417
31,3104,3104100,مکتب ارباب سرور,Arbab Sarwar School,0,0,272,340,612
31,3104,3104104,مسجد جامع قریه زیارت,Zyarat village Jame Mosque,0,0,63,548,611
31,3105,3105113,مکتب محله پایی,Muhallah Payeen School,0,0,49,1064,1113
31,3105,3105127,مسجد ملا سلطان,Mulla Sultan Mosque,0,0,551,1633,2184
31,3105,3105132,مسجد مولوی نصرالدین,Mawlawi Nasruddin Mosque,0,207,0,25,232
31,3105,3105133,مکتب اکازی ها,Akazai ha School,0,70,75,2854,2999
31,3105,3105134,کلینیک مرغاب,Murghab clinic,0,0,330,0,330
31,3105,3105135,مکتب مرکز مرغاب,Markaz Murghab School,0,0,0,3208,3208
31,3105,3105136,مسجدنوآباد,Nawabad Mosque,0,5,911,1153,2069
31,3105,3105137,مکتب قبچاق کپه بابا,Qubchaq Kapah Ba Ba School,0,196,542,2100,2838
31,3105,3105138,مکتب جوی خواجه,Joi Khwajah School,0,242,234,1156,1632
31,3106,3106145,مسجد قریه چشمه چهار,Chashmah Chahar village Mosque,0,0,577,1074,1651
31,3106,3106146,مسجد چشمه بید,Chashma Bed Mosque,0,0,187,1001,1188
31,3106,3106147,مسجد قریه قاز,Qaz village Mosque,0,2,549,1027,1578
31,3106,3106148,مسجد سرتاوه,Sartawah Mosque,0,0,482,1065,1547
31,3106,3106149,مسجد قریه اورگو,Urgo village Mosque,0,0,448,1070,1518
31,3106,3106150,فضای آزاد,Fazai Aza (Open ground),0,1,50,494,545
31,3106,3106160,مسجد قریه غو کلان,Ghu Kalan village Mosque,0,2,170,498,670
31,3106,3106161,مسجد فریه کازک,Kazak village Mosque,0,0,471,517,988
31,3106,3106163,مسجد سمبه کیچ,Sambah Keech Mosque,0,0,327,532,859
31,3106,3106164,مسجد قریه تخت زرد,Takht Zard village Mosque,0,0,502,662,1164
31,3106,3106173,مکتب چهار تاق,Chahar Taq School,0,1,195,868,1064
31,3106,3106183,مکتب آب خور,Aab Khor School,0,2,555,1066,1623
31,3106,3106186,مکتب خامی,Khameen School,0,1,977,1105,2083
31,3107,3107193,ابگرمک,Aabgarmak,0,43,245,864,1152
31,3107,3107195,مسجد قریه پبتو,Pabtu village Mosque,0,15,331,803,1149
31,3107,3107196,مکتب مرکز,Maktab Markaz (Center School),0,278,219,1427,1924
32,3202,3202052,مکتب کهدستان,Kuhdastan School,0,1,1325,1444,2770
32,3202,3202053,لیسه صف الدین,Safiuddin High School,0,16,497,922,1435
32,3202,3202054,لیسه جهاد,Jihad High School,0,1,895,731,1627
32,3202,3202055,مکتب متوسطه تاوه بریان,Tawah Biryan Secondary School,0,35,1044,1038,2117
32,3202,3202056,مكتب متوسطه شهدا,Shuhada Secondary School,0,1,459,352,812
32,3202,3202057,لیسه سر آسیاب,Sar Asyab High School,0,10,575,669,1254
32,3202,3202058,مکتب اما م شش نور,Imam Shash Noor School,0,0,618,1094,1712
32,3202,3202059,لیسه نوبادام,Nawbadam High School,0,0,258,358,616
32,3202,3202060,مکتب متوسطه دخبانه سفید روان,Safid Rawan Girls Secondary School,0,0,193,338,531
32,3202,3202061,مکتب تریاک,Taryak School,0,0,185,287,472
32,3202,3202062,مکتب متوسطه ادران,Adran Secondary School,0,0,500,694,1194
32,3202,3202063,مکتب بزدانک انجیل,Buzdanak Injeel School,0,1,248,475,724
32,3202,3202064,ليسه نوين عليا,Naween Ulya High School,0,0,758,795,1553
32,3202,3202065,مسجد جامع بلند آب,Biland Aab Jame Mosque,0,0,109,137,246
32,3202,3202066,ليسه چونگر,Chongar High School,0,4,1085,1007,2096
32,3202,3202067,مکتب گرداب,Gerdab School,0,0,254,246,500
32,3202,3202068,مکتب متوسطه کبابیان,Kababyan Secondary School,0,2,1186,1166,2354
32,3202,3202069,مجتمع فرهنگ قبان سنگر,Qezan Sangar Cultural Forum,0,8,876,941,1825
32,3202,3202070,مکتب متوسطه سروستان,Sarwestan Secondary School,0,0,1207,1340,2547
32,3202,3202071,مکتب نوین سفلی,Naween Sufla School,0,0,688,832,1520
32,3202,3202072,مكتب ابتدائ ابوريحان الببوئ,Abu Rehan Alberouni Primary School,0,0,613,709,1322
32,3202,3202073,مسجد شیخ محمد عمر,Shiekh Mohammad Omer Mosque,0,1,849,1058,1908
32,3202,3202074,مسجد شهداء کارته,Shuhadah e Kartah Mosque,0,1,1690,1543,3234
32,3202,3202075,لیسه قفسلان,Qafsalan High School,0,3,1614,1495,3112
32,3202,3202076,مسجد جامع مرغز,Marghuz Jame Mosque,0,0,320,412,732
32,3202,3202077,مکتب متوسطه خواجه عبیدالله احرار,Khwajah Obaidullah Ahrar Secondary School,0,0,261,293,554
32,3202,3202078,مکتب متوسطه شمعان,Shamaan Secondary School,0,70,1056,1080,2206
32,3202,3202079,لیسه جغرتان,Jaghartan High School,0,2,525,663,1190
32,3202,3202080,مکتب کبزان,Kebarzan School,0,0,353,643,996
32,3202,3202081,مسجد رباط سروستان,Rubat Sarwestan Mosque,0,0,83,98,181
32,3202,3202082,مکتب محل ناجوها,Mahal Naju ha School,0,0,635,594,1229
32,3202,3202083,مکتب متوسطه پوران,Puran Secondary School,0,100,1063,903,2066
32,3202,3202084,ليسه گاوبتان,Gaw butan High School,0,0,1373,1477,2850
32,3202,3202085,لیسه تلاب,Talab High School,0,0,281,300,581
32,3202,3202086,مکتب ابتدائ صوفیان,Soufyan Primary School,0,0,766,836,1602
32,3202,3202087,لیسه رواشان,Rawashan High School,0,8,1720,1611,3339
32,3202,3202088,لیسه آبجلیل,Aab Jalil High School,0,2,695,555,1252
32,3202,3202089,مکتب متوسطه کشک بادصبا,Kushk Bad Saba Secondary School,0,0,218,138,356
32,3202,3202090,مکتب خالد بن ولید,Khalid Bin Walid School,0,78,454,796,1328
32,3202,3202091,دفب مهاجرین,Daftar Muhajereen (Refugees Office),0,16,556,1312,1884
32,3202,3202092,مکتب متوسطه خواجه محمد کوهی,Khwajah Mohammad Kohi Secondary School,0,1,3148,2534,5683
32,3202,3202093,لیسه اسحق سلیمان,Ishaq Sulaiman High School,0,2,1722,2000,3724
32,3202,3202094,مکتب متوسطه پروانه,Parwanah Secondary School,0,2,656,701,1359
32,3202,3202095,مکتب چاهک,Chahak School,0,69,202,298,569
32,3203,3203096,مکتب متوسطه فرجائ,Farjayee Secondary School,0,1,394,445,840
32,3203,3203097,مکتب متوسطه ده نو,Deh Naw Secondary School,0,10,384,463,857
32,3203,3203098,مکتب متوسطه تبان,Teezan Secondary School,0,0,771,1144,1915
32,3203,3203099,لیسه کلاته خلیل,Kalatah Khalil High School,0,121,628,685,1434
32,3203,3203100,لیسه کوفان,Kofan High School,0,10,829,1009,1848
32,3203,3203101,لیسه زیارت جا,Zyarat Ja High School,0,0,1055,1418,2473
32,3203,3203102,لیسه مالان,Malan High School,0,0,430,689,1119
32,3203,3203103,لیسه امب شاهی,Amir Shahi High School,0,2,832,1064,1898
32,3203,3203104,مکتب متوسطه زنگان,Zangan Secondary School,0,0,372,384,756
32,3203,3203105,مکتب متوسطه تنغارشان,Tanghar Shan Secondary School,0,0,469,567,1036
32,3203,3203106,لیسه شمس الدین کورت,Shamsuddin Kort High School,0,1,926,1199,2126
32,3203,3203107,لیسه ناگهان,Nagahan High School,0,8,996,1210,2214
32,3203,3203108,نساج,Nasaji,0,4,1466,1591,3061
32,3203,3203109,لیسه ذکور مرغاب,Murghab Boys High School,0,1,432,493,926
32,3203,3203110,مکتب دخبانه قریه شکور خائ,Shukoor Khani village Girls School,0,0,1438,1679,3117
32,3203,3203111,لیسه وزیر فتح خان,Wazir Fateh Khan High School,0,45,1678,2038,3761
32,3203,3203112,مسجد شهرک صنعت,Shahrak Sanati (Industrial estate) Mosque,0,2,997,2046,3045
32,3203,3203113,لیسه خواجه شهاب,Khwajah Shahab High School,0,2,676,1183,1861
32,3203,3203114,لیسه خواجه محمد کنجائ,Khwajah Mohammad Kanjani High School,0,10,1011,1828,2849
32,3203,3203115,لیسه وحدت کورت علیا,Wahdat Kort Ulya High School,0,104,1129,2271,3504
32,3203,3203116,مکتب ابتدائیه کل خرما,Kul Khorma Primary School,0,0,517,479,996
32,3203,3203117,لیسه نشی بالا,Nesheen Bala High School,0,19,1119,1463,2601
32,3203,3203118,مکتب ابتدائ رباط مبک,Rubat Meerak Primary School,0,0,296,423,719
32,3203,3203119,لیسه دادشان,Dadshan High School,0,0,353,864,1217
32,3203,3203120,مکتب ابتدائ رباط سفچ,Rubat Safchi Primary School,0,3,255,421,679
32,3203,3203122,مکتب متوسطه چشمه خوائ,Chashmah Khawani Secondary School,0,1,1005,1491,2497
32,3203,3203123,مکتب متوسطه پشت کوه ملا یاسی,Pusht Koh e Mulla Yassin Secondary School,0,0,262,337,599
32,3203,3203125,موقعیت کوج های سراب پایی,"Kochis location, Sharab Payeen",0,77,1041,1250,2368
32,3203,3203127,مکتب ابتدائیه گل هزار,Gul Hazar Primary School,0,1,1150,1261,2412
32,3204,3204129,مکتب جنده خان,Jandah Khan School,0,0,951,896,1847
32,3204,3204130,مکتب متوسطه پهلوان پبی,Pahlawan Peeri Secondary School,0,0,1390,1515,2905
32,3204,3204131,مکتب اسلام آباد,Islamabad School,0,17,983,1118,2118
32,3204,3204132,مکتب کورپه,Korpah School,0,1,946,914,1861
32,3204,3204133,مکتب فالبکار,Falizkar School,0,0,276,218,494
32,3204,3204134,مکتب علی آباد,Ali Abad School,0,26,320,478,824
32,3204,3204135,مکتب مجقندک,Majqandak School,0,3,775,1121,1899
32,3204,3204136,مکتب درخت توت,Derakht Toot School,0,8,178,269,455
32,3204,3204137,مکتب دهن غار,Dahan Ghar School,0,2,520,662,1184
32,3204,3204138,مسجد سب پوش,Sabz Posh Mosque,0,0,1197,1014,2211
32,3204,3204139,لیسه مرکز کرخ,Markaz Karukh High School,0,1,1824,2310,4135
32,3204,3204140,مکتب قلعه سربت,Qalla Sharbat School,0,2,707,806,1515
32,3204,3204141,مکتب معلومه,Maloomah School,0,1,311,400,712
32,3204,3204142,مکتب سنجور,Sanjoor School,0,0,325,593,918
32,3204,3204143,مکتب مبزا بهار,Mirza Bahar School,0,3,562,637,1202
32,3204,3204144,مكتب ارملق,Armulq School,0,18,831,565,1414
32,3204,3204145,مکتب بادام تو,Badam Tu School,0,0,452,389,841
32,3204,3204146,مسجدچوئ,Chobi Mosque,0,1,456,502,959
32,3205,3205149,مکتب ابتدائ ده سرخ,Deh Surkh Primary School,0,0,1302,1272,2574
32,3205,3205150,مکتب قلعه یادگار,Qalla e Yadgar School,0,0,867,959,1826
32,3205,3205151,مکتب کبوتر خان,Kabotar Khan School,0,0,511,568,1079
32,3205,3205153,کلنیک پهره,Pehrah clinic,0,0,93,153,246
32,3205,3205155,مکتب جدید ملکی ها,Malaki ha new School,0,0,535,451,986
32,3205,3205156,مکتب محل خواجه ها,Mahal Khwaja ha School,0,0,681,471,1152
32,3205,3205157,مسجد قلعه نو,Qalla e Naw Mosque,0,0,733,631,1364
32,3205,3205158,مکتب فوشنج,Foshanj School,0,0,589,572,1161
32,3205,3205159,مكتب ابتدائ امبمعاويه,Amir Ma’awia Primary School,0,0,724,644,1368
32,3205,3205160,مکتب چار دره,Char Darah School,0,0,327,341,668
32,3205,3205161,مکتب ابو منصورشکیبان,Abu Mansour Shekeban School,0,0,752,752,1504
32,3205,3205162,مکتب شیخ ابولیث,Shiekh Abu Lais School,0,1,171,138,310
32,3205,3205163,مکتب جاده شاده,Jadah Shadah School,0,0,525,396,921
32,3206,3206164,مکتب غوران,Ghoran School,0,0,386,386,772
32,3206,3206165,مکتب بوکه,Bokah School,0,1,535,616,1152
32,3206,3206166,مکتب سر آب,Sar Aab School,0,1,499,552,1052
32,3206,3206167,مکتب سلیمی,Saleemi School,0,0,469,854,1323
32,3206,3206168,مکتب تونیون,Tuneon School,0,20,481,1124,1625
32,3206,3206170,مکتب مبل,Manzil School,0,0,389,685,1074
32,3206,3206171,مسجد جامع ده شیخ,Deh Shiekh Jame Mosque,0,0,125,357,482
32,3206,3206172,لیسه گل مب,Gul Mir High School,0,0,270,621,891
32,3206,3206173,مکتب شاه آباد,Shah Abad School,0,2,731,891,1624
32,3206,3206174,مکتب معموره,Ma’morah School,0,0,106,252,358
32,3206,3206176,مکتب ابتدائ کشک سبوان,Kashak Sairwan Primary School,0,0,52,67,119
32,3206,3206177,مسجد دوغ آباد,Dogh Abad Mosque,0,0,186,357,543
32,3206,3206178,لیسه مرکز گیم,Markaz Game High School,0,2,604,1484,2090
32,3206,3206179,مکتب متوسطه بند آباد,Band Abad Secondary School,0,0,277,614,891
32,3206,3206180,مکتب بزیان,Buzyan School,0,0,18,110,128
32,3206,3206181,مکتب پشکان اول,Peshkan Awal School,0,0,237,622,859
32,3206,3206187,مکتب دشت نبان,Dasht Nezan School,0,0,421,1560,1981
32,3206,3206189,مکتب تاقجه,Taqjah School,0,0,470,539,1009
32,3207,3207193,مكتب چهار اولنگ,Chahar Awlang School,0,75,1466,1870,3411
32,3207,3207194,مسجد قلعه سفید ایوئ,Qalla Safid Ayubi Mosque,0,0,169,273,442
32,3207,3207195,مکتب خواجه قاسم,Khwajah Qasim School,0,2,168,283,453
32,3207,3207196,لیسه دخبانه مرکز کشک رباط سنگ,Markaz Keshak Rubat Sangi Girls High School,0,6,567,563,1136
32,3207,3207197,مكتب خواجه ملال,Khwajah Malal School,0,1,569,857,1427
32,3207,3207198,مکتب باغچه,Baghchah School,0,2,276,374,652
32,3207,3207199,مکتب خلیفه رحمت,Khalifa Rahmat School,0,0,473,551,1024
32,3207,3207200,مکتب جعفر بیک کاودائ,Jafar Baig Kawdani School,0,0,126,191,317
32,3207,3207202,مکتب خواجه نور,Khwajah Noor School,0,19,742,918,1679
32,3207,3207204,مکتب لک لک خانه,Lak Lak Khanah School,0,0,226,282,508
32,3207,3207207,مکتب یک درخت,Yak Derakht School,0,0,331,186,517
32,3207,3207208,مکتب شبوائ,Sherwayee School,0,1,442,549,992
32,3207,3207211,مکتب شهید محمد اسماعیل بای,Shaheed Mohammad Ismael Bye School,0,0,411,281,692
32,3207,3207213,مکتب یکه توت,Yaka Toot School,0,28,556,762,1346
32,3207,3207215,مکتب خواجه جب,Khwajah Jeer School,0,1,443,1155,1599
32,3207,3207216,مکتب لیسه نسوان,Girls High School,0,88,1085,954,2127
32,3207,3207217,مکتب تورغندی اول,Torghondi Awal School,0,17,558,2164,2739
32,3207,3207218,مکتب بر جنک,Bar Janak School,0,0,986,458,1444
32,3207,3207221,مکتب چپقل,Chapqul School,0,0,460,491,951
32,3207,3207222,مکتب خلاوک ها,Khalawak ha School,0,55,869,1849,2773
32,3207,3207223,مكتب دوغ قنات وكيل,Doghi Qanat Wakeel School,0,1,721,864,1586
32,3207,3207224,مکتب دوغ دیزوری دوم,Doghi Dezori Doum School,0,0,897,1135,2032
32,3207,3207225,مکتب خواجه گلبید,Khwajah Gulbed School,0,0,200,393,593
32,3207,3207226,مکتب هفتو,Haftu School,0,1,605,727,1333
32,3207,3207227,مکتب کاریزخوئ,Alaf Haji Abdul Ahad School,0,0,220,301,521
32,3207,3207228,مکتب کاریز نو,Karez Naw School,0,0,343,573,916
32,3207,3207229,مكتب خواجه سب پوش,Khwajah Sabz Posh School,0,0,38,396,434
32,3208,3208254,مسجد آسیاب دیو,Asyab Dew Mosque,0,0,212,236,448
32,3208,3208256,مکتب زیره گ کلان,Zerah Gai Kalan School,0,1,262,453,716
32,3208,3208257,لیسه قره باغ,Qarah Bagh High School,0,0,1290,1394,2684
32,3208,3208258,مکتب بزان علیاء,Buzan Ulya School,0,0,157,243,400
32,3208,3208260,مکتب شکر آب,Shakar Aab School,0,0,75,49,124
32,3208,3208262,مکتب سنگ کوتل افضل,Sang Kotal Afzal School,0,0,158,343,501
32,3208,3208263,مسجد خواجه محمد شورآب,Khwaja Mohammad Shor Aab Mosque,0,1,282,313,596
32,3209,3209271,مکتب ابتدائیه ده سب,Deh Sabz Primary School,0,0,128,179,307
32,3209,3209272,مکتب ابتدائ قلعه خرچان,Qalla Kharchan Primary School,0,0,41,35,76
32,3209,3209273,لیسه مرکز ولسوالی,District Center High School,0,1,1018,2876,3895
32,3209,3209274,مكتب ابتدائ كال يك پايه,Kal Yak Payah Primary School,0,1,529,887,1417
32,3209,3209275,مسجد چهار سنگ,Chahar Sang Mosque,0,1,326,0,327
32,3209,3209276,مکتب متوسطه مبعلی,Mir Ali Secondary School,0,0,301,321,622
32,3210,3210295,مسجد حصرت محمد (ص),Hazrat Mohammad Mosque,0,0,558,670,1228
32,3210,3210296,مسجد قریه سرسره,Shar Sharah village Mosque,0,185,493,638,1316
32,3210,3210297,مسجد حصرت عمر (رض),Hazrat Omer Mosque,0,1,208,459,668
32,3210,3210299,مسجد جامع گله چغر,Gelah Chaghar Jame Mosque,0,0,492,528,1020
32,3210,3210301,مکتب زنده حشم,Zindah Hashm School,0,0,377,551,928
32,3210,3210303,مکتب خواجه شهاب,Khwajah Shahab School,0,0,304,580,884
32,3210,3210304,مکتب متوسطه جوی سلطائ,Joi Sultani Secondary School,0,21,834,766,1621
32,3210,3210305,مسجد جامع کاریز زمان,Karez Zaman Jame Mosque,0,6,578,878,1462
32,3210,3210307,مسجد بازار کهنه,Old Bazar Mosque,0,2,481,1190,1673
32,3210,3210308,مکتب متوسطه پسران ککلم اول,Pesaran kaklam Awal Secondary School,0,0,543,1305,1848
32,3210,3210309,مسجد حاج عبدالحمید,Haji Abdul Hamid Mosque,0,1,402,774,1177
32,3210,3210310,مسجد جامع لهر سرخ,Lehr e Surkh Jame Mosque,0,0,233,916,1149
32,3210,3210311,مسجد بلند محمد آباد چشمه خاف مردا,Cheshma Khawafi Bland Abad Mosque,0,0,240,ه310,550
32,3211,3211313,مسجد جامع گندم منه,Gandum Manah Jame Mosque,0,0,968,781,1749
32,3211,3211314,مسجدجامع عبدالله خان,Abdullah Khan Jame Mosque,0,0,1016,868,1884
32,3211,3211315,مسجد جامع قیسان,Qaisan Jame Mosque,0,0,983,907,1890
32,3211,3211316,مکتب وزیر اکب خان,Wazir Akbar Khan School,0,1,1120,1415,2536
32,3211,3211317,مکتب دخبانه مرکز ولسوالی سرک شفاخ,"Girls School, District Center , Hospital Road",0,10,1639,ن9ه136,3018
32,3211,3211318,مسجدجامع خواجه جمعان,Khwajah Jamaan Jame Mosque,0,1,684,161,846
32,3211,3211319,مسجد مولوی سراج,Mawlawi Seraj Mosque,0,1,1137,1494,2632
32,3211,3211320,مسجد سرآسیاب,Sar Asyab Mosque,0,1,867,768,1636
32,3211,3211321,مسجدغنجان,Ghinjan Mosque,0,3,803,586,1392
32,3211,3211322,مسجدبلوچ ها,Balouch ha Mosque,0,5,298,161,464
32,3211,3211323,مکتب ابتدائ استونان,Astanan Primary School,0,0,1008,1170,2178
32,3211,3211324,مکتب نو آباد,Nawabad School,0,1,556,638,1195
32,3211,3211325,مکتب دخبانه برنآباد زنانه,Barnabad girls School,0,2,589,1919,2510
32,3211,3211326,مسجد جامع روج,Rouj Jame Mosque,0,0,951,723,1674
32,3211,3211327,مسجد جامع سبول,Sabol Jame Mosque,0,2,1425,1483,2910
32,3211,3211328,مسجد زنگ صبا,Zangi Saba Mosque,0,1,934,1037,1972
32,3211,3211329,مکتب شبش,Shebesh School,0,1,1012,1114,2127
32,3211,3211330,مسجد جامع چاه ریگ,Chah Reg JameMosque,0,0,851,579,1430
32,3212,3212336,مکتب چناران مردانه,Chinaran Boys School,0,1,419,881,1301
32,3212,3212337,مسجد جامع کرشک مردانه,Kareshk Men Jame Mosque,0,0,576,1380,1956
32,3212,3212338,مکتب سبوان,Sairwan School,0,0,254,1012,1266
32,3212,3212340,لیسه ذکور گناباد,Gunabad Boys High School,0,2,142,428,572
32,3212,3212341,مسجد مسافران,Musaferan Mosque,0,0,158,420,578
32,3212,3212342,مسجد قریه کویان,Koyan village Mosque,0,0,202,711,913
32,3212,3212343,مکتب دخبانه مرکز اوبه دوم,Markaz Obah Doum Girls School,0,6,250,742,998
32,3212,3212344,لیسه مرکز اوبه,Markaz Obah High School,0,0,234,998,1232
32,3212,3212346,مکتب اناث بند بنفش,Band Benafsh Girls School,0,0,135,318,453
32,3212,3212348,مکتب سرا پرده,Sara Pardah School,0,1,153,496,650
32,3212,3212349,مکتب پسرانه ناب,Nab Boys School,0,0,0,193,193
32,3212,3212350,مسجد جامع کرغوض,Karghoz Jame Mosque,0,0,239,496,735
32,3212,3212351,مکتب جنوا مردانه,Janwa Boys School,0,0,50,367,417
32,3213,3213359,مکتب ابتدائ بای محمد,Bye Mohammad Primary School,0,0,265,315,580
32,3213,3213360,مکتب ابتدائ کمانه,Kamanah Primary School,0,0,741,839,1580
32,3213,3213361,مکتب ابتدائ بنیاد,Bunyad Primary School,0,1,1762,2329,4092
32,3213,3213362,مکتب متوسطه قزل اسلام,Qazal Islam Secondary School,0,0,391,292,683
32,3213,3213363,مکتب متوسطه نائب غفور,Nayeb Ghafoor Secondary School,0,1,671,757,1429
32,3213,3213364,مکتب ابتدائیه مصطف بیگ,Mustafa Baig Primary School,0,0,477,978,1455
32,3213,3213365,مکتب ابتدائ کلاته قاض,Kalatah Qazi Primary School,0,9,613,697,1319
32,3213,3213366,مکتب متوسطه اسلام قلعه,Islam Qalla Secondary School,0,2,1109,1163,2274
32,3213,3213367,مکتب سرافت,Sharafat School,0,2,499,0,501
32,3213,3213368,مکتب کارائ معارف,Karayee Ma’aref School,0,4,1174,1476,2654
32,3213,3213369,مکتب قدوس آباد دوم,Qudus Abad Doum School,0,3,810,1388,2201
32,3213,3213370,مسجد قریه ته خم,The Kham village Mosque,0,0,123,129,252
32,3213,3213371,لیسه کهسان,Kuhsan High School,0,0,1021,1093,2114
32,3213,3213372,مکتب ابتدائیه قلعه سردار,Qalla Sardar Primary School,0,0,0,266,266
32,3213,3213375,مکتب ابتدائ احمد آباد,Ahmad Abad Primary School,0,0,2124,2152,4276
32,3214,3214376,مرکز شاروالی,Municipality Center,0,0,193,642,835
32,3214,3214377,صحت عامه,Public Health,0,0,130,396,526
32,3214,3214378,مکتب دخبانه مبسادات,Mir Sadat Girls School,0,1,483,766,1250
32,3214,3214379,مکتب شورآب,Shor Aab School,0,0,578,621,1199
32,3214,3214381,مکتب شبآباد،خیفان دوم,"Sher Abad School, Khefan Doum",0,1,342,957,1300
32,3214,3214384,مسجدجامع نو,Masjid Jame Naw (New Jame Mosque),0,1,31,108,140
32,3214,3214385,مسجد خطیب نصرآبادی,Khateeb Naser Abadi Mosque,0,0,28,84,112
32,3214,3214386,مسجد حاج علاوالدین خان,Haji Allaudin Khan Mosque,0,4,161,640,805
32,3214,3214387,مکتب کهنه سنگ,Kuhnah Sang School,0,0,403,1025,1428
32,3214,3214388,لیسه نسوان خواجه نوح,Khwajah Nouh Girls High School,0,0,212,540,752
32,3214,3214389,مسجد عبدالله خان,Abdullah Khan Mosque,0,0,9,85,94
32,3215,3215392,مسجد حاج باغ,Haji Bagh Mosque,0,0,239,583,822
32,3215,3215394,مکتب دخبانه,Girls School,0,0,8,20,28
32,3215,3215396,تعمب شورای انکشاف,Community Development Council building,0,0,839,1111,1950
32,3216,3216404,مکتب آروی ج,Aarwej School,0,0,296,324,620
32,3216,3216407,مسجد جامع تگاب غزه,Tagab Ghazah Jame Mosque,0,0,1,1,2
32,3216,3216408,مسجد کبوتر خان,Kabotar Khan Mosque,0,0,16,25,41
32,3216,3216409,مکتب اسد الله چشت,Asadullah Chushti School,0,0,110,234,344
32,3216,3216410,مسجد سر تگاب,Sar Tagab Mosque,0,0,114,104,218
32,3216,3216411,مکتب سید محمد زاهد,Sayed Mohammad Zahid School,0,0,10,21,31
32,3216,3216412,مکتب سلما,Salma School,0,0,0,34,34
32,3216,3216413,مسجد جامع شبخاج,Sher Khaj Jame Mosque,0,3,18,89,110
32,3219,3219446,کلینیک خبآباد,Khairabad clinic,0,2,61,1050,1113
32,3220,3220454,لیسه بوبکرصدیق,Abu Baker Sedique High School,0,1,328,735,1064
32,3220,3220457,کلنیک حیوائ,Viterenary Clinic,0,1,527,1035,1563
32,320101,3201001,لیسه گوهرشاد,Gowhar shad High School,0,3,4072,3121,7196
32,320101,3201002,محبس هرات,Herat prison,0,0,11,50,61
32,320101,3201003,لیسه سلطان,Sultan High School,0,2,577,3440,4019
32,320102,3201004,لیسه ملکه جلالی,Malikah Jalali High School,0,0,1320,1455,2775
32,320102,3201005,مکتب لیسه اسپی ادی,Speen Ade High School,0,0,969,644,1613
32,320103,3201006,لیسه خواجه محمد تاکی,Khwajah Mohammad Taki High School,0,22,1764,4284,6070
32,320103,3201007,لیسه جامی,Jami High School,0,0,403,1218,1621
32,320103,3201008,مسجد الرضا,Al Reza Mosque,0,0,2901,3101,6002
32,320104,3201009,لیسه ذکور بالیا ن,Balyan Boys High School,0,4,1928,1660,3592
32,320104,3201010,لیسه هاتف,Hatifi High School,0,10,2574,2146,4730
32,320105,3201011,لیسه انقلاب,Inqelab High School,0,3,1156,3267,4426
32,320105,3201012,لیسه مهری,Mahri High School,0,3,2785,4092,6880
32,320105,3201013,منب مهدیه غور درواز,Menbar Mehdiah Ghor Darwaz,0,1,1373,1670,3044
32,320105,3201014,لیسه مبمن حیائ (باغدشت),Merman Hayat (Baghdasht) High School,0,0,2182,1597,3779
32,320105,3201015,لیسه تجربوی,Experimental High School,0,2,4301,2937,7240
32,320105,3201016,پوهنتون جديد,Pohantoon Jadeed (New University),0,0,932,1367,2299
32,320105,3201017,ليسه استقلال باغ دشت,Isteqlal High School Baghdasht,0,1,858,1388,2247
32,320106,3201018,مسجدعثما ن غت,Usman Ghani Mosque,0,1,1282,1171,2454
32,320106,3201019,مسجد چهار یار کبار,Chahar Yar Kubar Mosque,0,0,698,830,1528
32,320106,3201020,لیسه پل رنگینه,Pul Rangeenah High School,0,9,1990,2121,4120
32,320106,3201021,مسجد پل رگینه,Pul Rangeenah Mosque,0,2,2697,3272,5971
32,320106,3201022,مکتب متوسطه کارته امی,Kartah Ameen Secondary School,0,12,1904,1879,3795
32,320107,3201023,مجتمع خواهران,Mujtame Khwaharan (Sisters Forum),0,27,742,1304,2073
32,320107,3201024,مکتب صلاح الدین سلجوف,Salahuddin Saljoqi School,0,6,2501,3967,6474
32,320107,3201025,مسجد جامع توحید,Tawheed Jame Mosque,0,0,1730,1870,3600
32,320107,3201026,لیسه حصرت عمر فاروق,Hazrat Omer Farouq High School,0,4,2519,2892,5415
32,320108,3201027,مکتب امب علی شبنوائ,Amir Ali Sher Nawayee School,0,17,3308,3585,6910
32,320108,3201028,ليسه استاد كمال الدين بهزاد,Ustad Kamaluddin Behzad High School,0,15,1242,1490,2747
32,320108,3201029,لیسه فکری سلجوف,Fikri Saljouqi High School,0,10,1757,2501,4268
32,320108,3201030,لیسه شهید مبویس صادق,Shaheed Mirwai Sadeq High School,0,9,787,724,1520
32,320109,3201031,مكتب بابا زنگ عطا,Ba Ba Zangi Ata School,0,2,2623,2712,5337
32,320109,3201032,لیسه دخبانه حوض کرباس,Hawz Karbas Girls High School,0,0,3717,3483,7200
32,320110,3201033,مرکز صچ جامع بابای برق,Ba Ba e Barq Health Center,0,8,1584,1995,3587
32,320110,3201034,لیسه سیف,Saifi High School,0,75,3487,3590,7152
32,320110,3201035,مکتب ابتدائ عاصم,Asim Secondary School,0,0,452,548,1000
32,320111,3201036,لیسه شهید دشت,Shaheed Dashti High School,0,0,491,842,1333
32,320111,3201037,مکتب متوسطه مولانا عبدالله شفیف ه,Mawlana Abdullah Shafiqi Herawi Secondary School,0,24,806,و5ی83,1665
32,320111,3201038,مسجد جامع نو آباد,Nawabad Jame Mosque,0,21,497,648,1166
32,320111,3201039,لیسه فتح نو آباد,Fatah Nawabad High School,0,15,4351,5218,9584
32,320112,3201040,مکتب دخبان سید قناد,Sayed Qanad Girls School,0,2,2135,1133,3270
32,320112,3201041,مكتب متوسطه سيد قناد,Sayed Qanad Secondary School,0,1,1509,1449,2959
32,320112,3201042,مکتب عبدالعلی شاه توج,Abdul Ali Shah Tokhi School,0,2,3043,2845,5890
32,320112,3201043,مسجد جامع مولانا جامی,Mawlana Jami Jame Mosque,0,2,802,1181,1985
32,320112,3201044,مکتب لیسه باباج,Ba Ba G High School,0,6,1737,2247,3990
32,320112,3201045,مکتب متوسطه خواجه محراب الدین ج,Khwajah Mehrabuddin Jami Secondary School,0,1,1539,0می115,2690
32,320113,3201046,مکتب دخبانه جبئیل,Jebraiel Girls School,0,0,4042,2920,6962
32,320113,3201047,مسجد جامع جبئيل,Jebraiel Jame Mosque,0,3,3412,3826,7241
32,320113,3201048,مکتب غلام قادر خان آزادائ,Ghulam Qader Khan Azadani School,0,2,1012,1054,2068
32,320113,3201049,لیسه داش خانه,Dash Khana High School,0,0,1565,1319,2884
32,320114,3201050,لیسه پایی آب,Payeen Aab High School,0,7,1886,2343,4236
32,320115,3201051,لیسه سردار محمد داود خان,Sardar Mohammad Daud Khan High School,0,39,1032,2241,3312
33,3301,3301001,لیسه نسوان روناخه,Ronakha Girls High School,0,51,1396,2682,4129
33,3301,3301002,لیسه نسوان ملالی میوند,Malalai Maiwand Girls High School,0,20,1353,1930,3303
33,3301,3301003,لیسه می من نازو,Merman Nazo High School,0,28,1756,4623,6407
33,3301,3301004,لیسه توفیق میزای,Taufeeq Mirzaii High School,0,22,1542,3187,4751
33,3301,3301005,انستیتوت زراعت,Agriculture Institute,0,29,889,2685,3603
33,3301,3301006,لیسه نسوان محبوبه پوپل,Mahbobah Popal Girls High School,0,9,1324,1010,2343
33,3301,3301007,لیسه ذکور,Boys High School,0,16,844,1212,2072
33,3301,3301008,مکتب متوسطه قلعه محمد,Qalla Mohammad Secondary School,0,4,648,737,1389
33,3301,3301009,مکتب متوسطه قریه ننگ آب,Nang Abad village Secondary School,0,8,382,727,1117
33,3301,3301011,لیسه شوراباد,Shorabad High School,0,0,145,178,323
33,3301,3301012,مکتب ذکور کاریزک,Karezak Boys School,0,14,221,375,610
33,3301,3301013,مکتب ابتدائیه اناث,Girls Primary School,0,4,68,124,196
33,3301,3301014,لیسه نسوان شی علی خان,Sher Ali Khan Girls High School,0,1,199,242,442
33,3301,3301023,مکتب متوسطه کرج,Kirji Secondary School,0,42,788,1407,2237
33,3301,3301024,مکتب بخت اباد,Bakht Abad School,0,26,341,1413,1780
33,3301,3301025,استدیوم ورزش,Sports Stadium,0,20,386,1134,1540
33,3301,3301026,ریاست ترانسپورت وهوانوردی,Transport and Aviation Directorate,0,1,195,341,537
33,3301,3301027,لیسه نسوان,Girls High School,0,6,385,1380,1771
33,3301,3301028,مکتب متوسطه ریگ کلان,Regi Kalan Secondary School,0,2,241,309,552
33,3301,3301029,مسجد قلعه بهبود,Qalla Behbod Mosque,0,0,257,318,575
33,3301,3301030,لیسه مردانه قریه یزده,Yazdah village Boys High School,0,1,1039,1196,2236
33,3301,3301031,لیسه چهار باغ,Chahar Bagh High School,0,27,445,519,991
33,3301,3301032,مکتب ابتدایه سنگ زور,Sang Zor High School,0,10,864,1530,2404
33,3301,3301033,لیسه اناث,Girls High School,0,15,1278,1701,2994
33,3301,3301035,لیسه مردانه رج,Raj Boys High School,0,0,4,13,17
33,3301,3301036,لیسه مردانه گینهکان,Genahkan Boys High School,0,0,361,453,814
33,3301,3301037,لیسه ملا معی,Mulla Moeen High School,0,42,460,866,1368
33,3301,3301038,متوسطه حاج عبدالرحمن نیکه,Haji Abdul Rahman Nekah Secondary School,0,88,541,880,1509
33,3302,3302045,لیسه خواجه عبدالله بیدار,Khwajah Abdullah Bedar High School,0,0,0,296,296
33,3304,3304070,مسجد کشکک,Keshkak Mosque,0,9,285,848,1142
33,3305,3305091,لیسه کی,Keen High School,0,0,110,234,344
33,3306,3306109,مسجد دوراهی,Du Rahi Mosque,0,1,0,1059,1060
33,3306,3306111,کلینیک فراهرود,Farahrod clinic,0,0,0,536,536
33,3306,3306119,سپی مسجد,Speen Majid Mosque,0,0,0,709,709
33,3306,3306123,مکتب ابتدائیه نواباد,Nawabad Primary School,0,0,0,590,590
33,3307,3307132,لیسه شیخ عبدالصمد نظری,Shiekh Abdul Samad Nazari High School,0,30,857,1017,1904
33,3308,3308146,مسجد مرکز ( سلطان بکواه ),Masjid Markaz (Sultan Bakwah) Mosque,0,13,0,559,572
33,3309,3309161,مکتب نسوان لفتان,Luftan Girls School,0,0,557,561,1118
33,3309,3309162,لیسه ذکور ابن ایمن جوین,Ibne Aiman Jowaini Boys High School,0,0,1747,1714,3461
33,3309,3309164,مسجد علیا چار گاواک,Char gawak Ulya Mosque,0,0,560,570,1130
33,3310,3310185,مسجد مغل آباد,Mughul Abad Mosque,0,13,111,553,677
33,3311,3311202,مکتب تولی,Tolai School,0,0,2,130,132
33,3311,3311204,مسجد استوی,Asthoi Mosque,0,0,0,99,99
33,3311,3311224,مسجد برفشار,Barfshar Mosque,0,0,0,45,45
34,3401,3401001,لیسه رودآبه,Rodaabah High School,0,76,3758,6224,10058
34,3401,3401002,مکتب ابتدای زرنج,Zaranj Primary School,0,17,1812,2687,4516
34,3401,3401003,ریاست زراعت,Agriculture Directorate,0,1,677,1779,2457
34,3401,3401004,لیسه نسوان,Girls High School,0,9,1262,2841,4112
34,3401,3401005,لیسه فرخ,Farukhi High School,0,8,885,2878,3771
34,3401,3401006,لیسه ملکی,Mulki (Civil) High School,0,1,516,557,1074
34,3401,3401007,مکتب متوسطه شورو,Shuru Secondary School,0,14,135,274,423
34,3401,3401008,مکتب ابتدای فیوزه گ,Ferozah gai Secondary School,0,1,524,866,1391
34,3401,3401009,مکتب ابتدای سیاه دک,Syah Dak Primary School,0,9,411,744,1164
34,3401,3401010,لیسه نسوان شهید ناهید,Shaheed Nahid Girls High School,0,7,1113,1328,2448
34,3401,3401011,کمپ هندیها (مرکز اضافه شده),Hindus Camp (PC added),0,15,595,2256,2866
34,3401,3401012,لیسه مختلط قادر خان,Qader Khan Boys and Girls High School,0,3,564,781,1348
34,3401,3401013,لیسه ذکور شهید حبیب,Shaheed Habib Boys High School,0,38,1156,2050,3244
34,3401,3401014,مکتب ابتدای عبدالرحمان پهوال,Abdul Rahman Pahwal Primary School,0,16,849,1113,1978
34,3401,3401015,مکتب متوسطه غلام حیدر خان,Ghulam Haider Khan Secondary School,0,120,1297,1862,3279
34,3401,3401016,لیسه عبدالرحمن لالا,Abdul Rahman Lala High School,0,5,586,1613,2204
34,3401,3401068,خوابگاه,Khab Gah,0,0,3,253,256
34,3402,3402017,مکتب ریئس,Raees School,0,9,749,1092,1850
34,3402,3402018,مکتب ماککی,Makakai School,0,5,905,425,1335
34,3402,3402019,مکتب درویش,Darwesh School,0,1,4,688,693
34,3402,3402020,مکتب گرگیج,Gargej School,0,2,258,442,702
34,3402,3402021,مکتب طلای,Telayee School,0,3,658,1774,2435
34,3402,3402022,مکتب حاخ نت جان,Haji Nabi Jan School,0,1,155,189,345
34,3402,3402023,مکتب دشت,Dasht School,0,8,299,442,749
34,3402,3402024,مکتب دهک ناروی,Dehak Naroyee School,0,0,442,904,1346
34,3402,3402025,مکتب کرگ,Karkai School,0,0,570,887,1457
34,3403,3403030,مکتب قریه دنو,Deh Naw village School,0,29,910,1370,2309
34,3403,3403031,مکتب قریه حسن شیدل,Hassan Sherdil village School,0,14,314,439,767
34,3403,3403032,مکتب قریه امی بنیاد,Amir Bunyad village School,0,2,146,410,558
34,3403,3403033,مکتب صاحبداد,Sahib dad School,0,1,173,312,486
34,3403,3403034,مکتب قریه شاقیس,Shaqais village School,0,0,192,200,392
34,3403,3403035,مکتب سرکنگ,Sarkang School,0,6,107,227,340
34,3403,3403036,خانه اجتماعی,Khanah Ijtemai (Social hall),0,7,468,851,1326
34,3403,3403037,مکتب سرگز,Sargaz School,0,0,431,552,983
34,3403,3403038,مکتب جدید,Maktab Jadeed (new School),0,7,850,1125,1982
34,3404,3404040,مکتب اشکنک,Ashkanak School,0,104,566,2153,2823
34,3404,3404042,مکتب جدید,Maktab Jadeed (new School),0,7,360,513,880
34,3404,3404043,مکتب پده گ زیارت,Pudahgi Zyarat School,0,4,145,231,380
34,3404,3404044,مسجد کرکت,Cricketi Mosque,0,11,312,1126,1449
34,3404,3404045,مکتب چگت,Chagani School,0,1,242,431,674
34,3404,3404046,مکتب قلعه فتح,Qalla Fateh School,0,198,372,766,1336
34,3404,3404047,مکتب کرودی,Karodi School,0,1,104,214,319
34,3404,3404048,مسجدحضت ابوبکر صدیق,Hazrat Abu Baker Sediq Mosque,0,0,0,545,545
34,3405,3405049,لیسه حامد کرزی,Hamid Karzai High School,0,125,732,3810,4667
34,3405,3405055,مکتب منار,Minar School,0,9,0,2191,2200
34,3406,3406061,مسجد قریه گاومیش,Gawmeshi village Mosque,0,2,0,911,913
34,3406,3406062,مکتب قادریه,Qaderia School,0,17,0,4629,4646
34,3406,3406063,مکتب ابتدای نقشبندیه,Naqshbandia Primary School,0,3,0,1753,1756
34,3406,3406064,مکتب ابتدای ذکور,Boys Primary School,0,6,2,2197,2205
34,3406,3406065,مکتب,School,0,3,0,1163,1166